rank_number,actor,contributions,percent,cumulative_sum,cumulative_percent,all_contributions
1,sunnylovestiramisu,325,1.22637,325,1.22637,26501
2,johncowen,320,1.20750,645,2.43387,26501
3,Nithish555,308,1.16222,953,3.59609,26501
4,jackHU1998,209,0.78865,1162,4.38474,26501
5,TommyStarK,186,0.70186,1348,5.08660,26501
6,judemars,172,0.64903,1520,5.73563,26501
7,changluyi,157,0.59243,1677,6.32806,26501
8,yijiem,125,0.47168,1802,6.79974,26501
9,Seaiii,123,0.46413,1925,7.26388,26501
10,blueorangutan,116,0.43772,2041,7.70160,26501
11,cloudjumpercat,108,0.40753,2149,8.10913,26501
12,dtfranz,94,0.35470,2243,8.46383,26501
13,MrOrangeAndHam,92,0.34716,2335,8.81099,26501
14,yzxiu,83,0.31320,2418,9.12418,26501
15,sunnybhambhani,78,0.29433,2496,9.41851,26501
16,danielvegamyhre,76,0.28678,2572,9.70529,26501
17,caroline-suse-rancher,73,0.27546,2645,9.98076,26501
18,pchandra19,72,0.27169,2717,10.25244,26501
19,Bryce-Soghigian,69,0.26037,2786,10.51281,26501
20,DaviMatheus,67,0.25282,2853,10.76563,26501
21,Jordan9500,61,0.23018,2914,10.99581,26501
22,KB5201314,61,0.23018,2975,11.22599,26501
23,ramil600,59,0.22263,3034,11.44862,26501
24,little-willy,56,0.21131,3090,11.65994,26501
25,fabianrbz,55,0.20754,3145,11.86748,26501
26,abrugaro,53,0.19999,3198,12.06747,26501
27,juliafmorgado,51,0.19245,3249,12.25991,26501
28,kangsheng89,51,0.19245,3300,12.45236,26501
29,pridhi-arora,51,0.19245,3351,12.64481,26501
30,roberttoyonaga,51,0.19245,3402,12.83725,26501
31,withgaurav,51,0.19245,3453,13.02970,26501
32,drodil,47,0.17735,3500,13.20705,26501
33,adwaitni,46,0.17358,3546,13.38063,26501
34,donnachaforde,43,0.16226,3589,13.54289,26501
35,fuaiyi,43,0.16226,3632,13.70514,26501
36,stephenandary,42,0.15848,3674,13.86363,26501
37,hs05june,41,0.15471,3715,14.01834,26501
38,partik03,41,0.15471,3756,14.17305,26501
39,ayushthe1,39,0.14716,3795,14.32021,26501
40,davideduma,39,0.14716,3834,14.46738,26501
41,IlyaSavich,39,0.14716,3873,14.61454,26501
42,GoshaDo,38,0.14339,3911,14.75793,26501
43,shentupenghui,38,0.14339,3949,14.90132,26501
44,3point2,37,0.13962,3986,15.04094,26501
45,superdeen,37,0.13962,4023,15.18056,26501
46,zalsader,37,0.13962,4060,15.32018,26501
47,Bhargav-InfraCloud,36,0.13584,4096,15.45602,26501
48,GaganpreetKaurKalsi,36,0.13584,4132,15.59186,26501
49,graynk,36,0.13584,4168,15.72771,26501
50,mrthinger,36,0.13584,4204,15.86355,26501
51,desenna,35,0.13207,4239,15.99562,26501
52,ethanresnick,35,0.13207,4274,16.12769,26501
53,tinaselenge,35,0.13207,4309,16.25976,26501
54,weikhor,35,0.13207,4344,16.39183,26501
55,Y-dc,35,0.13207,4379,16.52390,26501
56,AleksandarFaraj,34,0.12830,4413,16.65220,26501
57,Rohitrajak1807,34,0.12830,4447,16.78050,26501
58,yanfeng1992,34,0.12830,4481,16.90880,26501
59,yuanman0109,34,0.12830,4515,17.03709,26501
60,EuricoAbreu,33,0.12452,4548,17.16162,26501
61,michalvavrik,33,0.12452,4581,17.28614,26501
62,Udit-takkar,33,0.12452,4614,17.41066,26501
63,tenshinhigashi,32,0.12075,4646,17.53141,26501
64,amirrmonfared,31,0.11698,4677,17.64839,26501
65,harikannan512,31,0.11698,4708,17.76537,26501
66,RohitKochhar,31,0.11698,4739,17.88234,26501
67,davozeni,30,0.11320,4769,17.99555,26501
68,gopivaibhav,30,0.11320,4799,18.10875,26501
69,Musab1258,30,0.11320,4829,18.22195,26501
70,corbinu,29,0.10943,4858,18.33138,26501
71,rcpandula,29,0.10943,4887,18.44081,26501
72,shubhbapna,29,0.10943,4916,18.55024,26501
73,Thomasr-02,29,0.10943,4945,18.65967,26501
74,zedi-pramodh,29,0.10943,4974,18.76910,26501
75,239573049,28,0.10566,5002,18.87476,26501
76,CodeFarmerPK,28,0.10566,5030,18.98042,26501
77,jadsy2107,28,0.10566,5058,19.08607,26501
78,philberryman,28,0.10566,5086,19.19173,26501
79,sknop-cgn,28,0.10566,5114,19.29739,26501
80,Tangruilin,28,0.10566,5142,19.40304,26501
81,yoavkatzman,28,0.10566,5170,19.50870,26501
82,cbianchi-7,27,0.10188,5197,19.61058,26501
83,eljohnson92,27,0.10188,5224,19.71246,26501
84,francesco-racciatti,27,0.10188,5251,19.81435,26501
85,PratikforCoding,27,0.10188,5278,19.91623,26501
86,rrangith,27,0.10188,5305,20.01811,26501
87,AS-AlStar,26,0.09811,5331,20.11622,26501
88,IssaAbuKalbein,26,0.09811,5357,20.21433,26501
89,lmonkiewicz,26,0.09811,5383,20.31244,26501
90,rodrigodelmonte,26,0.09811,5409,20.41055,26501
91,sfc-gh-kleonhard,26,0.09811,5435,20.50866,26501
92,woofyzhao,26,0.09811,5461,20.60677,26501
93,yuvalweber,26,0.09811,5487,20.70488,26501
94,zhaohuiweixiao,26,0.09811,5513,20.80299,26501
95,ibotdotout,25,0.09434,5538,20.89732,26501
96,isaac-jordan,25,0.09434,5563,20.99166,26501
97,jlojosnegros,25,0.09434,5588,21.08600,26501
98,Rileran,25,0.09434,5613,21.18033,26501
99,steenzout,25,0.09434,5638,21.27467,26501
100,zeuson0,25,0.09434,5663,21.36900,26501
101,bestofman,24,0.09056,5687,21.45957,26501
102,iamjesh,24,0.09056,5711,21.55013,26501
103,jhagborgftx,24,0.09056,5735,21.64069,26501
104,jolavb,24,0.09056,5759,21.73126,26501
105,kylejb,24,0.09056,5783,21.82182,26501
106,ycjiang50,24,0.09056,5807,21.91238,26501
107,aitherios,23,0.08679,5830,21.99917,26501
108,baomingwang,23,0.08679,5853,22.08596,26501
109,emmayylu,23,0.08679,5876,22.17275,26501
110,hueypark,23,0.08679,5899,22.25954,26501
111,kishorerj,23,0.08679,5922,22.34633,26501
112,LAMRobinson,23,0.08679,5945,22.43312,26501
113,myccccccc,23,0.08679,5968,22.51990,26501
114,quraynai,23,0.08679,5991,22.60669,26501
115,rjsadow,23,0.08679,6014,22.69348,26501
116,STLVRTX,23,0.08679,6037,22.78027,26501
117,Temppus,23,0.08679,6060,22.86706,26501
118,zhshw,23,0.08679,6083,22.95385,26501
119,0xSaksham,22,0.08302,6105,23.03687,26501
120,akundrock,22,0.08302,6127,23.11988,26501
121,alexweav,22,0.08302,6149,23.20290,26501
122,AwesomePatrol,22,0.08302,6171,23.28591,26501
123,hpvd,22,0.08302,6193,23.36893,26501
124,kimstacy,22,0.08302,6215,23.45195,26501
125,nikitar,22,0.08302,6237,23.53496,26501
126,yellowhat,22,0.08302,6259,23.61798,26501
127,yuangeqingian,22,0.08302,6281,23.70099,26501
128,adam-kiss-sg,21,0.07924,6302,23.78023,26501
129,aditi5050,21,0.07924,6323,23.85948,26501
130,AlexandreBrg,21,0.07924,6344,23.93872,26501
131,CappuccinoNyy,21,0.07924,6365,24.01796,26501
132,harrison-tin,21,0.07924,6386,24.09720,26501
133,mateusz-lubanski-sinch,21,0.07924,6407,24.17645,26501
134,mohang6770,21,0.07924,6428,24.25569,26501
135,Shivam-AfA,21,0.07924,6449,24.33493,26501
136,tr0njavolta,21,0.07924,6470,24.41417,26501
137,xianggao001,21,0.07924,6491,24.49342,26501
138,AlexandreRoux,20,0.07547,6511,24.56888,26501
139,ankitsingh241,20,0.07547,6531,24.64435,26501
140,hgaol,20,0.07547,6551,24.71982,26501
141,jdockerty,20,0.07547,6571,24.79529,26501
142,Kart121,20,0.07547,6591,24.87076,26501
143,MACEL94,20,0.07547,6611,24.94623,26501
144,MLintin,20,0.07547,6631,25.02170,26501
145,nandaleite,20,0.07547,6651,25.09717,26501
146,ngnix,20,0.07547,6671,25.17263,26501
147,Operate1,20,0.07547,6691,25.24810,26501
148,upxinxin,20,0.07547,6711,25.32357,26501
149,utezduyar,20,0.07547,6731,25.39904,26501
150,VibhavariMandal-sumo,20,0.07547,6751,25.47451,26501
151,abhijeet-26,19,0.07170,6770,25.54621,26501
152,arik-dig,19,0.07170,6789,25.61790,26501
153,Arindam200,19,0.07170,6808,25.68960,26501
154,baowj-678,19,0.07170,6827,25.76129,26501
155,nerucheva,19,0.07170,6846,25.83299,26501
156,pockyhe,19,0.07170,6865,25.90468,26501
157,VedRatan,19,0.07170,6884,25.97638,26501
158,whitemanthedj,19,0.07170,6903,26.04807,26501
159,AtticusLv,18,0.06792,6921,26.11600,26501
160,castroricardo1,18,0.06792,6939,26.18392,26501
161,chenchunping,18,0.06792,6957,26.25184,26501
162,Fatimastm,18,0.06792,6975,26.31976,26501
163,giusdp,18,0.06792,6993,26.38768,26501
164,gogoiakash2311,18,0.06792,7011,26.45561,26501
165,jameshearttech,18,0.06792,7029,26.52353,26501
166,jzabroski,18,0.06792,7047,26.59145,26501
167,leotomas837,18,0.06792,7065,26.65937,26501
168,myrondev,18,0.06792,7083,26.72729,26501
169,nickstenning,18,0.06792,7101,26.79522,26501
170,Robunnin,18,0.06792,7119,26.86314,26501
171,tahirraza,18,0.06792,7137,26.93106,26501
172,Vishvsalvi,18,0.06792,7155,26.99898,26501
173,zhang-x-z,18,0.06792,7173,27.06690,26501
174,abhilipsasahoo03,17,0.06415,7190,27.13105,26501
175,amarflybot,17,0.06415,7207,27.19520,26501
176,IcebergXTY,17,0.06415,7224,27.25935,26501
177,imaxun,17,0.06415,7241,27.32350,26501
178,jtovartr,17,0.06415,7258,27.38765,26501
179,krupyansky,17,0.06415,7275,27.45179,26501
180,miles170,17,0.06415,7292,27.51594,26501
181,MisterSquishy,17,0.06415,7309,27.58009,26501
182,officialajkim,17,0.06415,7326,27.64424,26501
183,rahulk789,17,0.06415,7343,27.70839,26501
184,RamezesDong,17,0.06415,7360,27.77254,26501
185,RapperCL,17,0.06415,7377,27.83669,26501
186,Saza-ku,17,0.06415,7394,27.90083,26501
187,simonbaird,17,0.06415,7411,27.96498,26501
188,sky333999,17,0.06415,7428,28.02913,26501
189,sr185436,17,0.06415,7445,28.09328,26501
190,TKTheTechie,17,0.06415,7462,28.15743,26501
191,Vaani-pathariya,17,0.06415,7479,28.22158,26501
192,vitor-pinto-maersk,17,0.06415,7496,28.28573,26501
193,walterlife,17,0.06415,7513,28.34987,26501
194,Aarav238,16,0.06038,7529,28.41025,26501
195,deepakdinesh1123,16,0.06038,7545,28.47062,26501
196,exander77,16,0.06038,7561,28.53100,26501
197,Gauravmeenu,16,0.06038,7577,28.59137,26501
198,hsadoyan,16,0.06038,7593,28.65175,26501
199,JavierSegoviaCordoba,16,0.06038,7609,28.71212,26501
200,JosephABC,16,0.06038,7625,28.77250,26501
201,kyakdan,16,0.06038,7641,28.83287,26501
202,LilTwo,16,0.06038,7657,28.89325,26501
203,liustanley,16,0.06038,7673,28.95362,26501
204,Lucas-Desouza,16,0.06038,7689,29.01400,26501
205,matanshk2,16,0.06038,7705,29.07437,26501
206,nicoleblom,16,0.06038,7721,29.13475,26501
207,oderwat,16,0.06038,7737,29.19512,26501
208,pbnPierre,16,0.06038,7753,29.25550,26501
209,Sajiyah-Salat,16,0.06038,7769,29.31587,26501
210,sb185296,16,0.06038,7785,29.37625,26501
211,ShivangShandilya,16,0.06038,7801,29.43663,26501
212,tglaeser,16,0.06038,7817,29.49700,26501
213,tibrn,16,0.06038,7833,29.55738,26501
214,ageoffron,15,0.05660,7848,29.61398,26501
215,BillyChen1,15,0.05660,7863,29.67058,26501
216,Braundo,15,0.05660,7878,29.72718,26501
217,Chandan-Abhyankar,15,0.05660,7893,29.78378,26501
218,gtcooke94,15,0.05660,7908,29.84038,26501
219,ironoa,15,0.05660,7923,29.89699,26501
220,lhardt,15,0.05660,7938,29.95359,26501
221,mathiasbronner,15,0.05660,7953,30.01019,26501
222,maximrub,15,0.05660,7968,30.06679,26501
223,octothorped,15,0.05660,7983,30.12339,26501
224,PailaGH,15,0.05660,7998,30.17999,26501
225,PaulBernier,15,0.05660,8013,30.23659,26501
226,RRobot-lm,15,0.05660,8028,30.29320,26501
227,tanberBro,15,0.05660,8043,30.34980,26501
228,yutingcaiyt,15,0.05660,8058,30.40640,26501
229,aditya-shrivastavv,14,0.05283,8072,30.45923,26501
230,athityakumar,14,0.05283,8086,30.51206,26501
231,awsprof,14,0.05283,8100,30.56488,26501
232,byronchien,14,0.05283,8114,30.61771,26501
233,ChezBunch,14,0.05283,8128,30.67054,26501
234,christianoguedes,14,0.05283,8142,30.72337,26501
235,dpfaffenbauer,14,0.05283,8156,30.77620,26501
236,edwintye,14,0.05283,8170,30.82903,26501
237,haoqixu,14,0.05283,8184,30.88185,26501
238,Japan50079,14,0.05283,8198,30.93468,26501
239,joeybrown-sf,14,0.05283,8212,30.98751,26501
240,Kuroneer,14,0.05283,8226,31.04034,26501
241,lalitc375,14,0.05283,8240,31.09317,26501
242,luukasmakila,14,0.05283,8254,31.14599,26501
243,lyj0309,14,0.05283,8268,31.19882,26501
244,matschaffer-roblox,14,0.05283,8282,31.25165,26501
245,maxm0rt,14,0.05283,8296,31.30448,26501
246,mdf-ido,14,0.05283,8310,31.35731,26501
247,mmamczur,14,0.05283,8324,31.41014,26501
248,PauloGoncalvesLima,14,0.05283,8338,31.46296,26501
249,procheta1999,14,0.05283,8352,31.51579,26501
250,QuinceyJames,14,0.05283,8366,31.56862,26501
251,ravi-nal,14,0.05283,8380,31.62145,26501
252,riteshsonawane1372,14,0.05283,8394,31.67428,26501
253,SpringHgui,14,0.05283,8408,31.72710,26501
254,t4niwa,14,0.05283,8422,31.77993,26501
255,ThomasDangleterre,14,0.05283,8436,31.83276,26501
256,VaibhavSharma-47,14,0.05283,8450,31.88559,26501
257,wenxu1024,14,0.05283,8464,31.93842,26501
258,YLShiJustFly,14,0.05283,8478,31.99125,26501
259,yujinkim-msft,14,0.05283,8492,32.04407,26501
260,yunchen-myob,14,0.05283,8506,32.09690,26501
261,YunWZ,14,0.05283,8520,32.14973,26501
262,anlandu,13,0.04905,8533,32.19878,26501
263,bouaouda-achraf,13,0.04905,8546,32.24784,26501
264,Coolomina,13,0.04905,8559,32.29689,26501
265,cprice404,13,0.04905,8572,32.34595,26501
266,elliotgunton,13,0.04905,8585,32.39500,26501
267,Hexcles,13,0.04905,8598,32.44406,26501
268,jargals2,13,0.04905,8611,32.49311,26501
269,jelhub,13,0.04905,8624,32.54217,26501
270,jingai-db,13,0.04905,8637,32.59122,26501
271,Karthik-PM,13,0.04905,8650,32.64028,26501
272,kxs-sindrakumar,13,0.04905,8663,32.68933,26501
273,Lincoln-developer,13,0.04905,8676,32.73839,26501
274,linshiyx,13,0.04905,8689,32.78744,26501
275,LinuxAd,13,0.04905,8702,32.83650,26501
276,littlejiancc,13,0.04905,8715,32.88555,26501
277,mohite-abhi,13,0.04905,8728,32.93461,26501
278,Mouness,13,0.04905,8741,32.98366,26501
279,nihil2501,13,0.04905,8754,33.03272,26501
280,Rupsnigdha,13,0.04905,8767,33.08177,26501
281,sjbarag,13,0.04905,8780,33.13083,26501
282,sondinht,13,0.04905,8793,33.17988,26501
283,songweirong19931020,13,0.04905,8806,33.22893,26501
284,spolab,13,0.04905,8819,33.27799,26501
285,ta1meng,13,0.04905,8832,33.32704,26501
286,thomasrichner-oviva,13,0.04905,8845,33.37610,26501
287,uMartinXu,13,0.04905,8858,33.42515,26501
288,yashhhguptaaa,13,0.04905,8871,33.47421,26501
289,aaccioly,12,0.04528,8883,33.51949,26501
290,adkafka,12,0.04528,8895,33.56477,26501
291,AleksVAnd,12,0.04528,8907,33.61005,26501
292,amentebekele-okta,12,0.04528,8919,33.65533,26501
293,ancostas,12,0.04528,8931,33.70062,26501
294,carabnuu,12,0.04528,8943,33.74590,26501
295,detvdl,12,0.04528,8955,33.79118,26501
296,DrDaveD,12,0.04528,8967,33.83646,26501
297,edubonifs,12,0.04528,8979,33.88174,26501
298,eighty4,12,0.04528,8991,33.92702,26501
299,el-mail,12,0.04528,9003,33.97230,26501
300,erm-g,12,0.04528,9015,34.01758,26501
301,fluzzykitten,12,0.04528,9027,34.06287,26501
302,graziadonghia,12,0.04528,9039,34.10815,26501
303,iastewar,12,0.04528,9051,34.15343,26501
304,karlparry,12,0.04528,9063,34.19871,26501
305,Krapi0314,12,0.04528,9075,34.24399,26501
306,kunkunhaohao,12,0.04528,9087,34.28927,26501
307,levi106,12,0.04528,9099,34.33455,26501
308,maocq,12,0.04528,9111,34.37983,26501
309,miklelappo,12,0.04528,9123,34.42512,26501
310,mnajdova,12,0.04528,9135,34.47040,26501
311,Naski86,12,0.04528,9147,34.51568,26501
312,Omkar-Waingankar,12,0.04528,9159,34.56096,26501
313,ouweijun1,12,0.04528,9171,34.60624,26501
314,pellmont,12,0.04528,9183,34.65152,26501
315,qicz,12,0.04528,9195,34.69680,26501
316,rcanderson23,12,0.04528,9207,34.74209,26501
317,SanthoshiMekala,12,0.04528,9219,34.78737,26501
318,sanyo0714,12,0.04528,9231,34.83265,26501
319,sassukeuchiha,12,0.04528,9243,34.87793,26501
320,segunjkf,12,0.04528,9255,34.92321,26501
321,ShelbyZ,12,0.04528,9267,34.96849,26501
322,shiraOvadia,12,0.04528,9279,35.01377,26501
323,Shuimo03,12,0.04528,9291,35.05905,26501
324,sqsp-rwatkins,12,0.04528,9303,35.10434,26501
325,steache,12,0.04528,9315,35.14962,26501
326,Tanmoy741127,12,0.04528,9327,35.19490,26501
327,tmeadon,12,0.04528,9339,35.24018,26501
328,TravisTroyer,12,0.04528,9351,35.28546,26501
329,voroninp,12,0.04528,9363,35.33074,26501
330,WoWsj,12,0.04528,9375,35.37602,26501
331,wXwcoder,12,0.04528,9387,35.42130,26501
332,Ziy1-Tan,12,0.04528,9399,35.46659,26501
333,1eedaegon,11,0.04151,9410,35.50809,26501
334,Alberic-Hardis,11,0.04151,9421,35.54960,26501
335,balajisa09,11,0.04151,9432,35.59111,26501
336,brettveenstra,11,0.04151,9443,35.63262,26501
337,cappellinsamuele,11,0.04151,9454,35.67413,26501
338,chinu-anand,11,0.04151,9465,35.71563,26501
339,chriss-de,11,0.04151,9476,35.75714,26501
340,ciprianna,11,0.04151,9487,35.79865,26501
341,claudiomerli,11,0.04151,9498,35.84016,26501
342,Code-Hex,11,0.04151,9509,35.88166,26501
343,CraneRZz,11,0.04151,9520,35.92317,26501
344,csworm-rudraksha,11,0.04151,9531,35.96468,26501
345,daiyyr,11,0.04151,9542,36.00619,26501
346,damelLP,11,0.04151,9553,36.04770,26501
347,elshad-faire,11,0.04151,9564,36.08920,26501
348,FabioBatSilva,11,0.04151,9575,36.13071,26501
349,glomikuz,11,0.04151,9586,36.17222,26501
350,hseshadr,11,0.04151,9597,36.21373,26501
351,Ipuvi,11,0.04151,9608,36.25524,26501
352,Jackmin801,11,0.04151,9619,36.29674,26501
353,JoeLoser,11,0.04151,9630,36.33825,26501
354,jpdeburgo,11,0.04151,9641,36.37976,26501
355,justinyjsong,11,0.04151,9652,36.42127,26501
356,jxyang,11,0.04151,9663,36.46277,26501
357,kai-tillman,11,0.04151,9674,36.50428,26501
358,kgnanaprakasam,11,0.04151,9685,36.54579,26501
359,kingkonghong,11,0.04151,9696,36.58730,26501
360,leonsteinhaeuser,11,0.04151,9707,36.62881,26501
361,maan19,11,0.04151,9718,36.67031,26501
362,mjbshaw,11,0.04151,9729,36.71182,26501
363,mortenjoenby,11,0.04151,9740,36.75333,26501
364,MrZLeo,11,0.04151,9751,36.79484,26501
365,nikolaik,11,0.04151,9762,36.83635,26501
366,NoahLovesLife,11,0.04151,9773,36.87785,26501
367,ocleo1,11,0.04151,9784,36.91936,26501
368,odupuy,11,0.04151,9795,36.96087,26501
369,prodion23,11,0.04151,9806,37.00238,26501
370,psadovsky,11,0.04151,9817,37.04389,26501
371,rikez,11,0.04151,9828,37.08539,26501
372,samirski,11,0.04151,9839,37.12690,26501
373,saurabh-io,11,0.04151,9850,37.16841,26501
374,scpcy,11,0.04151,9861,37.20992,26501
375,sfleener,11,0.04151,9872,37.25142,26501
376,Sindweller,11,0.04151,9883,37.29293,26501
377,sradu,11,0.04151,9894,37.33444,26501
378,sweetpotato0,11,0.04151,9905,37.37595,26501
379,thredreams,11,0.04151,9916,37.41746,26501
380,twity1337,11,0.04151,9927,37.45896,26501
381,varunkumare99,11,0.04151,9938,37.50047,26501
382,yang-maple,11,0.04151,9949,37.54198,26501
383,yolu-kxs,11,0.04151,9960,37.58349,26501
384,abhinavrastogi-harness,10,0.03773,9970,37.62122,26501
385,akorompai,10,0.03773,9980,37.65896,26501
386,alexfh,10,0.03773,9990,37.69669,26501
387,amcasey,10,0.03773,10000,37.73443,26501
388,anibmurthy,10,0.03773,10010,37.77216,26501
389,AniketNS,10,0.03773,10020,37.80989,26501
390,BabyElias,10,0.03773,10030,37.84763,26501
391,bcarlock-emerge,10,0.03773,10040,37.88536,26501
392,ch-enfuse,10,0.03773,10050,37.92310,26501
393,chrispoole643,10,0.03773,10060,37.96083,26501
394,chrroberts-pure,10,0.03773,10070,37.99857,26501
395,chunji08,10,0.03773,10080,38.03630,26501
396,dawitam11,10,0.03773,10090,38.07403,26501
397,deepan10,10,0.03773,10100,38.11177,26501
398,echel0n-TR,10,0.03773,10110,38.14950,26501
399,gauravrattan,10,0.03773,10120,38.18724,26501
400,harshithgandham,10,0.03773,10130,38.22497,26501
401,hasier,10,0.03773,10140,38.26271,26501
402,hiromu-a5a,10,0.03773,10150,38.30044,26501
403,ilbarone87,10,0.03773,10160,38.33818,26501
404,InnocentK,10,0.03773,10170,38.37591,26501
405,jhawkins1,10,0.03773,10180,38.41364,26501
406,JochenFriedrich,10,0.03773,10190,38.45138,26501
407,lenicatko,10,0.03773,10200,38.48911,26501
408,liam-thunder,10,0.03773,10210,38.52685,26501
409,linuxcrash,10,0.03773,10220,38.56458,26501
410,littlejoyo,10,0.03773,10230,38.60232,26501
411,lspiehler,10,0.03773,10240,38.64005,26501
412,mikhail-barg,10,0.03773,10250,38.67779,26501
413,MrBehl06,10,0.03773,10260,38.71552,26501
414,Nanfei-Chen,10,0.03773,10270,38.75325,26501
415,Nishant-sehgal,10,0.03773,10280,38.79099,26501
416,osexpert,10,0.03773,10290,38.82872,26501
417,Pietrokechi,10,0.03773,10300,38.86646,26501
418,rarora-21,10,0.03773,10310,38.90419,26501
419,rgunaseknokia,10,0.03773,10320,38.94193,26501
420,rsadowsk,10,0.03773,10330,38.97966,26501
421,sri53,10,0.03773,10340,39.01740,26501
422,suhail34,10,0.03773,10350,39.05513,26501
423,thake,10,0.03773,10360,39.09286,26501
424,timo-haas-by,10,0.03773,10370,39.13060,26501
425,UnmeshDeodhar,10,0.03773,10380,39.16833,26501
426,WaberZhuang,10,0.03773,10390,39.20607,26501
427,yf-odyssey,10,0.03773,10400,39.24380,26501
428,yyongycy,10,0.03773,10410,39.28154,26501
429,zcason,10,0.03773,10420,39.31927,26501
430,a092cc,9,0.03396,10429,39.35323,26501
431,a1lu,9,0.03396,10438,39.38719,26501
432,abhiptl,9,0.03396,10447,39.42115,26501
433,abrarcci,9,0.03396,10456,39.45511,26501
434,AgniveshChaubey,9,0.03396,10465,39.48908,26501
435,alexchowle,9,0.03396,10474,39.52304,26501
436,alinskens,9,0.03396,10483,39.55700,26501
437,aniaan,9,0.03396,10492,39.59096,26501
438,anoopvlcy,9,0.03396,10501,39.62492,26501
439,arjunan-k,9,0.03396,10510,39.65888,26501
440,Ashik008,9,0.03396,10519,39.69284,26501
441,asierHuawei,9,0.03396,10528,39.72680,26501
442,attiferosisal,9,0.03396,10537,39.76076,26501
443,AVASamsundar,9,0.03396,10546,39.79472,26501
444,b2k4j,9,0.03396,10555,39.82869,26501
445,bachittle,9,0.03396,10564,39.86265,26501
446,bilalba,9,0.03396,10573,39.89661,26501
447,bookinstock,9,0.03396,10582,39.93057,26501
448,cmunger,9,0.03396,10591,39.96453,26501
449,congiv,9,0.03396,10600,39.99849,26501
450,cynen,9,0.03396,10609,40.03245,26501
451,dangokuson,9,0.03396,10618,40.06641,26501
452,dfr,9,0.03396,10627,40.10037,26501
453,dreamerkr,9,0.03396,10636,40.13433,26501
454,egze,9,0.03396,10645,40.16830,26501
455,emon5122,9,0.03396,10654,40.20226,26501
456,emypar,9,0.03396,10663,40.23622,26501
457,erikbaranowski,9,0.03396,10672,40.27018,26501
458,evgenymarkov,9,0.03396,10681,40.30414,26501
459,feiyunzhou,9,0.03396,10690,40.33810,26501
460,gzkoala,9,0.03396,10699,40.37206,26501
461,HM-8,9,0.03396,10708,40.40602,26501
462,houhuiting,9,0.03396,10717,40.43998,26501
463,hunter32292,9,0.03396,10726,40.47394,26501
464,idexter,9,0.03396,10735,40.50791,26501
465,jackycsl,9,0.03396,10744,40.54187,26501
466,jaysonjdmello,9,0.03396,10753,40.57583,26501
467,jbrooks2-godaddy,9,0.03396,10762,40.60979,26501
468,jchadwick-buf,9,0.03396,10771,40.64375,26501
469,jeevanragula,9,0.03396,10780,40.67771,26501
470,Joey777210,9,0.03396,10789,40.71167,26501
471,kama910,9,0.03396,10798,40.74563,26501
472,kellinwood,9,0.03396,10807,40.77959,26501
473,Kickball,9,0.03396,10816,40.81355,26501
474,lanqingaa,9,0.03396,10825,40.84752,26501
475,limary,9,0.03396,10834,40.88148,26501
476,lisablack1,9,0.03396,10843,40.91544,26501
477,lucas-baldo,9,0.03396,10852,40.94940,26501
478,M1eyu2018,9,0.03396,10861,40.98336,26501
479,marcsvll,9,0.03396,10870,41.01732,26501
480,mathis-m,9,0.03396,10879,41.05128,26501
481,MatthewRalston,9,0.03396,10888,41.08524,26501
482,MihaZupan,9,0.03396,10897,41.11920,26501
483,mjgutermuth,9,0.03396,10906,41.15316,26501
484,MohamedShaj,9,0.03396,10915,41.18713,26501
485,Mskxn,9,0.03396,10924,41.22109,26501
486,nanfuka,9,0.03396,10933,41.25505,26501
487,Narenderbhcu,9,0.03396,10942,41.28901,26501
488,nbajaj90,9,0.03396,10951,41.32297,26501
489,netwarex,9,0.03396,10960,41.35693,26501
490,nRookie,9,0.03396,10969,41.39089,26501
491,PragyaGpt,9,0.03396,10978,41.42485,26501
492,q77190858,9,0.03396,10987,41.45881,26501
493,rbagd,9,0.03396,10996,41.49277,26501
494,rishitashaw,9,0.03396,11005,41.52673,26501
495,robertfemmer,9,0.03396,11014,41.56070,26501
496,rverma-uc,9,0.03396,11023,41.59466,26501
497,sarahjanenewnham,9,0.03396,11032,41.62862,26501
498,sbracegirdle,9,0.03396,11041,41.66258,26501
499,shrutich91,9,0.03396,11050,41.69654,26501
500,stanislavulrych,9,0.03396,11059,41.73050,26501
501,thiyagu06,9,0.03396,11068,41.76446,26501
502,tstackhouse,9,0.03396,11077,41.79842,26501
503,vikram-thiru,9,0.03396,11086,41.83238,26501
504,vinay50muddu,9,0.03396,11095,41.86634,26501
505,vvejell1,9,0.03396,11104,41.90031,26501
506,vvxxvvxx,9,0.03396,11113,41.93427,26501
507,wanghaao,9,0.03396,11122,41.96823,26501
508,Whisper40,9,0.03396,11131,42.00219,26501
509,xinzongyan,9,0.03396,11140,42.03615,26501
510,xuleiming,9,0.03396,11149,42.07011,26501
511,Yanghaihai1020,9,0.03396,11158,42.10407,26501
512,ycydk,9,0.03396,11167,42.13803,26501
513,zuzannapn,9,0.03396,11176,42.17199,26501
514,Aashish93-stack,8,0.03019,11184,42.20218,26501
515,a-berahman,8,0.03019,11192,42.23237,26501
516,Adarsh-verma-14,8,0.03019,11200,42.26256,26501
517,aengelas,8,0.03019,11208,42.29274,26501
518,agentq15,8,0.03019,11216,42.32293,26501
519,akakarikos,8,0.03019,11224,42.35312,26501
520,akash-mohanto,8,0.03019,11232,42.38331,26501
521,alexander-bauer,8,0.03019,11240,42.41349,26501
522,andreasgerstmayr,8,0.03019,11248,42.44368,26501
523,aopetrov86,8,0.03019,11256,42.47387,26501
524,aoterolorenzo,8,0.03019,11264,42.50406,26501
525,axrav,8,0.03019,11272,42.53424,26501
526,ays7,8,0.03019,11280,42.56443,26501
527,bhagirathhapse,8,0.03019,11288,42.59462,26501
528,brianmolinaspring,8,0.03019,11296,42.62481,26501
529,ChandanChainani,8,0.03019,11304,42.65499,26501
530,ChaningHwang,8,0.03019,11312,42.68518,26501
531,chargui-yassine,8,0.03019,11320,42.71537,26501
532,chipmunkie,8,0.03019,11328,42.74556,26501
533,chrisx8,8,0.03019,11336,42.77574,26501
534,Cool-Coder174,8,0.03019,11344,42.80593,26501
535,damonmaria,8,0.03019,11352,42.83612,26501
536,danieldradware,8,0.03019,11360,42.86631,26501
537,danmunteanuevo,8,0.03019,11368,42.89649,26501
538,datachi7d,8,0.03019,11376,42.92668,26501
539,davidwmartines,8,0.03019,11384,42.95687,26501
540,dbfancier,8,0.03019,11392,42.98706,26501
541,dimakuz,8,0.03019,11400,43.01724,26501
542,dlmiller322,8,0.03019,11408,43.04743,26501
543,doctorseus,8,0.03019,11416,43.07762,26501
544,draftcode,8,0.03019,11424,43.10781,26501
545,edsondearaujo,8,0.03019,11432,43.13799,26501
546,emilkje,8,0.03019,11440,43.16818,26501
547,eveforest,8,0.03019,11448,43.19837,26501
548,fazpeerbaksh,8,0.03019,11456,43.22856,26501
549,fejpet,8,0.03019,11464,43.25874,26501
550,flipsed,8,0.03019,11472,43.28893,26501
551,frenchtoasters,8,0.03019,11480,43.31912,26501
552,HaiKonofanDesu,8,0.03019,11488,43.34931,26501
553,hamidp555,8,0.03019,11496,43.37950,26501
554,HenryCaiHaiying,8,0.03019,11504,43.40968,26501
555,hernanpl,8,0.03019,11512,43.43987,26501
556,hiattp,8,0.03019,11520,43.47006,26501
557,icepuma,8,0.03019,11528,43.50025,26501
558,isayden,8,0.03019,11536,43.53043,26501
559,ivanszl,8,0.03019,11544,43.56062,26501
560,Jamess-Lucass,8,0.03019,11552,43.59081,26501
561,javaboboApp,8,0.03019,11560,43.62100,26501
562,jefftyn,8,0.03019,11568,43.65118,26501
563,jmd9019,8,0.03019,11576,43.68137,26501
564,Jolg42,8,0.03019,11584,43.71156,26501
565,JPFrancoia,8,0.03019,11592,43.74175,26501
566,juanmaia,8,0.03019,11600,43.77193,26501
567,JuanPabloSGU,8,0.03019,11608,43.80212,26501
568,Kaiass,8,0.03019,11616,43.83231,26501
569,kmcbride,8,0.03019,11624,43.86250,26501
570,knutejohKLP,8,0.03019,11632,43.89268,26501
571,KrylixZA,8,0.03019,11640,43.92287,26501
572,LarryOsterman,8,0.03019,11648,43.95306,26501
573,lprakashv,8,0.03019,11656,43.98325,26501
574,MahmoodKamali,8,0.03019,11664,44.01343,26501
575,mclean0328,8,0.03019,11672,44.04362,26501
576,mengtao97,8,0.03019,11680,44.07381,26501
577,Mert18,8,0.03019,11688,44.10400,26501
578,Mihai22125,8,0.03019,11696,44.13418,26501
579,monica0500,8,0.03019,11704,44.16437,26501
580,mpeyper,8,0.03019,11712,44.19456,26501
581,mwei0210,8,0.03019,11720,44.22475,26501
582,njohnstone2,8,0.03019,11728,44.25493,26501
583,omartheironman,8,0.03019,11736,44.28512,26501
584,omrozowicz-splunk,8,0.03019,11744,44.31531,26501
585,pbenas,8,0.03019,11752,44.34550,26501
586,prak30,8,0.03019,11760,44.37568,26501
587,proteche,8,0.03019,11768,44.40587,26501
588,prrajput1199,8,0.03019,11776,44.43606,26501
589,psbrar99,8,0.03019,11784,44.46625,26501
590,qrtt1,8,0.03019,11792,44.49643,26501
591,rajeshnayakmdCCD,8,0.03019,11800,44.52662,26501
592,rgc183,8,0.03019,11808,44.55681,26501
593,ruifung,8,0.03019,11816,44.58700,26501
594,rylim,8,0.03019,11824,44.61718,26501
595,saikumarjetti,8,0.03019,11832,44.64737,26501
596,sander-verhoeven,8,0.03019,11840,44.67756,26501
597,Sbolder,8,0.03019,11848,44.70775,26501
598,sdenovan,8,0.03019,11856,44.73793,26501
599,sebdah,8,0.03019,11864,44.76812,26501
600,seoyeomi,8,0.03019,11872,44.79831,26501
601,SergeyLadutko,8,0.03019,11880,44.82850,26501
602,ShlokMohanty,8,0.03019,11888,44.85868,26501
603,silenteh,8,0.03019,11896,44.88887,26501
604,springile,8,0.03019,11904,44.91906,26501
605,Tazer,8,0.03019,11912,44.94925,26501
606,testisnullus,8,0.03019,11920,44.97943,26501
607,tig0826,8,0.03019,11928,45.00962,26501
608,tilibougnia,8,0.03019,11936,45.03981,26501
609,tshinde-splunk,8,0.03019,11944,45.07000,26501
610,vickyhella,8,0.03019,11952,45.10018,26501
611,waterbrother,8,0.03019,11960,45.13037,26501
612,wujun4code,8,0.03019,11968,45.16056,26501
613,yuri-lcy,8,0.03019,11976,45.19075,26501
614,zhic0223,8,0.03019,11984,45.22094,26501
615,0xfei,7,0.02641,11991,45.24735,26501
616,5o11,7,0.02641,11998,45.27376,26501
617,Aann102030,7,0.02641,12005,45.30018,26501
618,Abhi149209,7,0.02641,12012,45.32659,26501
619,agtogna,7,0.02641,12019,45.35301,26501
620,AnaCarolinaRodriguesLeite,7,0.02641,12026,45.37942,26501
621,Andrew-xyz,7,0.02641,12033,45.40583,26501
622,ankexiaozi,7,0.02641,12040,45.43225,26501
623,AnnuCode,7,0.02641,12047,45.45866,26501
624,aspic,7,0.02641,12054,45.48508,26501
625,atorik,7,0.02641,12061,45.51149,26501
626,bootsieh,7,0.02641,12068,45.53790,26501
627,Bo-Qiu,7,0.02641,12075,45.56432,26501
628,brainiac84,7,0.02641,12082,45.59073,26501
629,bsalunke,7,0.02641,12089,45.61715,26501
630,bullno1,7,0.02641,12096,45.64356,26501
631,c0d3x42,7,0.02641,12103,45.66997,26501
632,carlospalmaroldan,7,0.02641,12110,45.69639,26501
633,cesarvspr,7,0.02641,12117,45.72280,26501
634,cinglese,7,0.02641,12124,45.74922,26501
635,cjc7373,7,0.02641,12131,45.77563,26501
636,clanghout,7,0.02641,12138,45.80205,26501
637,clibequilibrium,7,0.02641,12145,45.82846,26501
638,cniket,7,0.02641,12152,45.85487,26501
639,colin-williams,7,0.02641,12159,45.88129,26501
640,crigertg,7,0.02641,12166,45.90770,26501
641,DekusDenial,7,0.02641,12173,45.93412,26501
642,dgroenen,7,0.02641,12180,45.96053,26501
643,diegomazine,7,0.02641,12187,45.98694,26501
644,dmcdii,7,0.02641,12194,46.01336,26501
645,dominiksr,7,0.02641,12201,46.03977,26501
646,Dongqi-Guo,7,0.02641,12208,46.06619,26501
647,dxg0716,7,0.02641,12215,46.09260,26501
648,Ebi27,7,0.02641,12222,46.11901,26501
649,edysli,7,0.02641,12229,46.14543,26501
650,eshchap,7,0.02641,12236,46.17184,26501
651,eventgraph,7,0.02641,12243,46.19826,26501
652,FangyuanCaiWork,7,0.02641,12250,46.22467,26501
653,FedericoYST,7,0.02641,12257,46.25108,26501
654,FFock,7,0.02641,12264,46.27750,26501
655,fuzz,7,0.02641,12271,46.30391,26501
656,gradx,7,0.02641,12278,46.33033,26501
657,GVelnicu,7,0.02641,12285,46.35674,26501
658,henvic,7,0.02641,12292,46.38316,26501
659,HoangTheQuyen,7,0.02641,12299,46.40957,26501
660,hualongfeng,7,0.02641,12306,46.43598,26501
661,huliucheng1,7,0.02641,12313,46.46240,26501
662,hunshcn,7,0.02641,12320,46.48881,26501
663,italofernandes13,7,0.02641,12327,46.51523,26501
664,itsek,7,0.02641,12334,46.54164,26501
665,jakedoublev,7,0.02641,12341,46.56805,26501
666,jbottum,7,0.02641,12348,46.59447,26501
667,jeffreywstevens,7,0.02641,12355,46.62088,26501
668,jesafar,7,0.02641,12362,46.64730,26501
669,jgan129,7,0.02641,12369,46.67371,26501
670,jhailsecurity,7,0.02641,12376,46.70012,26501
671,Jim0530,7,0.02641,12383,46.72654,26501
672,jimmytsang,7,0.02641,12390,46.75295,26501
673,jobstoit,7,0.02641,12397,46.77937,26501
674,jonathan-dev,7,0.02641,12404,46.80578,26501
675,jordigh,7,0.02641,12411,46.83220,26501
676,juliusrickert,7,0.02641,12418,46.85861,26501
677,justinmans,7,0.02641,12425,46.88502,26501
678,kalverra,7,0.02641,12432,46.91144,26501
679,kavitajoshi14,7,0.02641,12439,46.93785,26501
680,kids12138,7,0.02641,12446,46.96427,26501
681,kj-creater,7,0.02641,12453,46.99068,26501
682,lazar-boradzhiev,7,0.02641,12460,47.01709,26501
683,maciej-karas-form3,7,0.02641,12467,47.04351,26501
684,maokitty,7,0.02641,12474,47.06992,26501
685,mayankA47,7,0.02641,12481,47.09634,26501
686,mdolinin,7,0.02641,12488,47.12275,26501
687,meSATYA,7,0.02641,12495,47.14916,26501
688,milank78git,7,0.02641,12502,47.17558,26501
689,moki1202,7,0.02641,12509,47.20199,26501
690,moting9,7,0.02641,12516,47.22841,26501
691,natiz,7,0.02641,12523,47.25482,26501
692,ncbraner,7,0.02641,12530,47.28123,26501
693,new-dream,7,0.02641,12537,47.30765,26501
694,nuritizra,7,0.02641,12544,47.33406,26501
695,PatrickGhadban,7,0.02641,12551,47.36048,26501
696,pentogram80,7,0.02641,12558,47.38689,26501
697,p-maks,7,0.02641,12565,47.41331,26501
698,portswigger-tim,7,0.02641,12572,47.43972,26501
699,p-slavcheva,7,0.02641,12579,47.46613,26501
700,QuadmanSWE,7,0.02641,12586,47.49255,26501
701,QuangVinhTran,7,0.02641,12593,47.51896,26501
702,racker7,7,0.02641,12600,47.54538,26501
703,ramobis,7,0.02641,12607,47.57179,26501
704,rinocata,7,0.02641,12614,47.59820,26501
705,rorychatterton,7,0.02641,12621,47.62462,26501
706,rufy2022,7,0.02641,12628,47.65103,26501
707,ryee0701,7,0.02641,12635,47.67745,26501
708,SakuraWh,7,0.02641,12642,47.70386,26501
709,schwmi,7,0.02641,12649,47.73027,26501
710,Shubhamurkade,7,0.02641,12656,47.75669,26501
711,shzshi,7,0.02641,12663,47.78310,26501
712,sokril,7,0.02641,12670,47.80952,26501
713,Sonu875,7,0.02641,12677,47.83593,26501
714,stefanpinterBE,7,0.02641,12684,47.86234,26501
715,SufyaanKhateeb,7,0.02641,12691,47.88876,26501
716,taju20910,7,0.02641,12698,47.91517,26501
717,tgib23,7,0.02641,12705,47.94159,26501
718,theluckiesthuman,7,0.02641,12712,47.96800,26501
719,Tom-python0121,7,0.02641,12719,47.99442,26501
720,ultimateJJ,7,0.02641,12726,48.02083,26501
721,vamshikrishna9999,7,0.02641,12733,48.04724,26501
722,Venture200,7,0.02641,12740,48.07366,26501
723,victtsl,7,0.02641,12747,48.10007,26501
724,vidommet,7,0.02641,12754,48.12649,26501
725,WillAbides,7,0.02641,12761,48.15290,26501
726,wubumihuo,7,0.02641,12768,48.17931,26501
727,yanglaoshi666,7,0.02641,12775,48.20573,26501
728,ZakariaNaaija,7,0.02641,12782,48.23214,26501
729,zyfcloud,7,0.02641,12789,48.25856,26501
730,abhinavramana,6,0.02264,12795,48.28120,26501
731,Ackuq,6,0.02264,12801,48.30384,26501
732,adr-xyt,6,0.02264,12807,48.32648,26501
733,al-cheb,6,0.02264,12813,48.34912,26501
734,Alucaz2022,6,0.02264,12819,48.37176,26501
735,andretong,6,0.02264,12825,48.39440,26501
736,andrewkreuzer,6,0.02264,12831,48.41704,26501
737,antonpirker,6,0.02264,12837,48.43968,26501
738,Anuragwagh,6,0.02264,12843,48.46232,26501
739,argadepp,6,0.02264,12849,48.48496,26501
740,arielly-parussulo,6,0.02264,12855,48.50760,26501
741,b4bay,6,0.02264,12861,48.53024,26501
742,bautistamad,6,0.02264,12867,48.55288,26501
743,bdehri,6,0.02264,12873,48.57553,26501
744,BenamarMk,6,0.02264,12879,48.59817,26501
745,BerGer23,6,0.02264,12885,48.62081,26501
746,brightdroid,6,0.02264,12891,48.64345,26501
747,brutif,6,0.02264,12897,48.66609,26501
748,bwojdyla,6,0.02264,12903,48.68873,26501
749,bzsuni,6,0.02264,12909,48.71137,26501
750,CaffeeLake,6,0.02264,12915,48.73401,26501
751,Callek,6,0.02264,12921,48.75665,26501
752,CastixGitHub,6,0.02264,12927,48.77929,26501
753,cell-kibet,6,0.02264,12933,48.80193,26501
754,cfis,6,0.02264,12939,48.82457,26501
755,chaochaoyuyu19880105,6,0.02264,12945,48.84721,26501
756,ChenWenming1995,6,0.02264,12951,48.86985,26501
757,chenxb0715,6,0.02264,12957,48.89249,26501
758,chrislbs,6,0.02264,12963,48.91514,26501
759,CSalih,6,0.02264,12969,48.93778,26501
760,csscriptplus,6,0.02264,12975,48.96042,26501
761,csuriano23,6,0.02264,12981,48.98306,26501
762,danielodievich,6,0.02264,12987,49.00570,26501
763,danmontgomery,6,0.02264,12993,49.02834,26501
764,DavidS-om,6,0.02264,12999,49.05098,26501
765,davsan-0,6,0.02264,13005,49.07362,26501
766,delca85,6,0.02264,13011,49.09626,26501
767,devopslyf,6,0.02264,13017,49.11890,26501
768,dhirenpsingh,6,0.02264,13023,49.14154,26501
769,digitalstudium,6,0.02264,13029,49.16418,26501
770,djcenox,6,0.02264,13035,49.18682,26501
771,dragonTour,6,0.02264,13041,49.20946,26501
772,Dreista,6,0.02264,13047,49.23210,26501
773,dwagelaar,6,0.02264,13053,49.25475,26501
774,elgatito,6,0.02264,13059,49.27739,26501
775,elitistphoenix,6,0.02264,13065,49.30003,26501
776,elizabeth-a-hobbs,6,0.02264,13071,49.32267,26501
777,entrymon,6,0.02264,13077,49.34531,26501
778,eva980636,6,0.02264,13083,49.36795,26501
779,fangfpeng,6,0.02264,13089,49.39059,26501
780,freesinger,6,0.02264,13095,49.41323,26501
781,frenchbread,6,0.02264,13101,49.43587,26501
782,fruitbox12,6,0.02264,13107,49.45851,26501
783,GantzGit,6,0.02264,13113,49.48115,26501
784,GeofoxCoding,6,0.02264,13119,49.50379,26501
785,GeunSam2,6,0.02264,13125,49.52643,26501
786,gintire,6,0.02264,13131,49.54907,26501
787,greatljn,6,0.02264,13137,49.57171,26501
788,gugdewescale,6,0.02264,13143,49.59435,26501
789,hanzai,6,0.02264,13149,49.61700,26501
790,hesch,6,0.02264,13155,49.63964,26501
791,hnd4r7,6,0.02264,13161,49.66228,26501
792,hoangduy1912,6,0.02264,13167,49.68492,26501
793,holgerson97,6,0.02264,13173,49.70756,26501
794,huy-phan-of,6,0.02264,13179,49.73020,26501
795,iamjpotts,6,0.02264,13185,49.75284,26501
796,illukin,6,0.02264,13191,49.77548,26501
797,ilrudie,6,0.02264,13197,49.79812,26501
798,imeshm98,6,0.02264,13203,49.82076,26501
799,issmirnov,6,0.02264,13209,49.84340,26501
800,j33lai,6,0.02264,13215,49.86604,26501
801,jbpal123,6,0.02264,13221,49.88868,26501
802,JessHolle,6,0.02264,13227,49.91132,26501
803,JoeAshworth,6,0.02264,13233,49.93396,26501
804,johndlong,6,0.02264,13239,49.95661,26501
805,johnna2020,6,0.02264,13245,49.97925,26501
806,jsilvela,6,0.02264,13251,50.00189,26501
807,juju812,6,0.02264,13257,50.02453,26501
808,justin-echternach,6,0.02264,13263,50.04717,26501
809,jwoehr,6,0.02264,13269,50.06981,26501
810,JYC0413,6,0.02264,13275,50.09245,26501
811,jyf-edited,6,0.02264,13281,50.11509,26501
812,kaplanben,6,0.02264,13287,50.13773,26501
813,katsuharu,6,0.02264,13293,50.16037,26501
814,kimfiedler,6,0.02264,13299,50.18301,26501
815,korthout,6,0.02264,13305,50.20565,26501
816,krstosavic,6,0.02264,13311,50.22829,26501
817,Laitr0n,6,0.02264,13317,50.25093,26501
818,LaurenzReitsam,6,0.02264,13323,50.27357,26501
819,Leo1003,6,0.02264,13329,50.29622,26501
820,leojeb,6,0.02264,13335,50.31886,26501
821,Linneaiv,6,0.02264,13341,50.34150,26501
822,lolverae,6,0.02264,13347,50.36414,26501
823,lowryxiao,6,0.02264,13353,50.38678,26501
824,Manohar-mj,6,0.02264,13359,50.40942,26501
825,marcandrews,6,0.02264,13365,50.43206,26501
826,MarkArranz,6,0.02264,13371,50.45470,26501
827,markdingo,6,0.02264,13377,50.47734,26501
828,MarkintoshZ,6,0.02264,13383,50.49998,26501
829,markvoll,6,0.02264,13389,50.52262,26501
830,mattxw,6,0.02264,13395,50.54526,26501
831,MaxMuzh,6,0.02264,13401,50.56790,26501
832,McGon-Fid,6,0.02264,13407,50.59054,26501
833,mecoding1,6,0.02264,13413,50.61318,26501
834,micheleissa,6,0.02264,13419,50.63583,26501
835,migldasilva,6,0.02264,13425,50.65847,26501
836,mitalipaygude,6,0.02264,13431,50.68111,26501
837,mkorzeniewski,6,0.02264,13437,50.70375,26501
838,mmoore0011,6,0.02264,13443,50.72639,26501
839,mohit-marathe,6,0.02264,13449,50.74903,26501
840,morphalus,6,0.02264,13455,50.77167,26501
841,msalei,6,0.02264,13461,50.79431,26501
842,nagkumar,6,0.02264,13467,50.81695,26501
843,naveenbansalntnx,6,0.02264,13473,50.83959,26501
844,njlaw,6,0.02264,13479,50.86223,26501
845,Nomiby,6,0.02264,13485,50.88487,26501
846,npivaut,6,0.02264,13491,50.90751,26501
847,nsinghal12,6,0.02264,13497,50.93015,26501
848,oscarchan76,6,0.02264,13503,50.95279,26501
849,pascal-sochacki,6,0.02264,13509,50.97543,26501
850,passie,6,0.02264,13515,50.99808,26501
851,patrickbardo,6,0.02264,13521,51.02072,26501
852,PeterL328,6,0.02264,13527,51.04336,26501
853,philipz,6,0.02264,13533,51.06600,26501
854,pjastrzabek-roche,6,0.02264,13539,51.08864,26501
855,pmuller,6,0.02264,13545,51.11128,26501
856,qi0523,6,0.02264,13551,51.13392,26501
857,qimiao1,6,0.02264,13557,51.15656,26501
858,qjerome,6,0.02264,13563,51.17920,26501
859,radiohead,6,0.02264,13569,51.20184,26501
860,RagibAjmal,6,0.02264,13575,51.22448,26501
861,RamakrishnaHande,6,0.02264,13581,51.24712,26501
862,reisman234,6,0.02264,13587,51.26976,26501
863,Rez0k,6,0.02264,13593,51.29240,26501
864,rfarajro,6,0.02264,13599,51.31504,26501
865,Riverdd,6,0.02264,13605,51.33769,26501
866,rogeriomm,6,0.02264,13611,51.36033,26501
867,ronz-sensible,6,0.02264,13617,51.38297,26501
868,saiharshitach,6,0.02264,13623,51.40561,26501
869,samarth96,6,0.02264,13629,51.42825,26501
870,sanchita-07,6,0.02264,13635,51.45089,26501
871,saweber,6,0.02264,13641,51.47353,26501
872,sbhrepo,6,0.02264,13647,51.49617,26501
873,sekasara,6,0.02264,13653,51.51881,26501
874,sergey-mesh-kong,6,0.02264,13659,51.54145,26501
875,sergiynesterenko90,6,0.02264,13665,51.56409,26501
876,shogohida,6,0.02264,13671,51.58673,26501
877,SKYkubeedge,6,0.02264,13677,51.60937,26501
878,smutukula,6,0.02264,13683,51.63201,26501
879,sofiafernandezmoreno,6,0.02264,13689,51.65465,26501
880,songkang7,6,0.02264,13695,51.67730,26501
881,sookeke,6,0.02264,13701,51.69994,26501
882,sosheskaz,6,0.02264,13707,51.72258,26501
883,srinusanduri,6,0.02264,13713,51.74522,26501
884,stone-98,6,0.02264,13719,51.76786,26501
885,summer-father,6,0.02264,13725,51.79050,26501
886,sylvia0409,6,0.02264,13731,51.81314,26501
887,tanshilingithub,6,0.02264,13737,51.83578,26501
888,tcomben,6,0.02264,13743,51.85842,26501
889,tfzhaod,6,0.02264,13749,51.88106,26501
890,thgm3116,6,0.02264,13755,51.90370,26501
891,TimoVerbrugghe,6,0.02264,13761,51.92634,26501
892,Trevor-Bond,6,0.02264,13767,51.94898,26501
893,ttohin,6,0.02264,13773,51.97162,26501
894,tuunit,6,0.02264,13779,51.99426,26501
895,tWatanabe0808,6,0.02264,13785,52.01691,26501
896,UjjawalTyagi123,6,0.02264,13791,52.03955,26501
897,umar-siddiqui-ivolve,6,0.02264,13797,52.06219,26501
898,VaibhavJangid,6,0.02264,13803,52.08483,26501
899,VenkateshChella,6,0.02264,13809,52.10747,26501
900,vivekcusat,6,0.02264,13815,52.13011,26501
901,vonjones,6,0.02264,13821,52.15275,26501
902,wanglongzhong,6,0.02264,13827,52.17539,26501
903,whitewindmills,6,0.02264,13833,52.19803,26501
904,Whitroom,6,0.02264,13839,52.22067,26501
905,x7upLime,6,0.02264,13845,52.24331,26501
906,xingleigao,6,0.02264,13851,52.26595,26501
907,xtineskim,6,0.02264,13857,52.28859,26501
908,yairyairyair,6,0.02264,13863,52.31123,26501
909,yasz24,6,0.02264,13869,52.33387,26501
910,zeusbee,6,0.02264,13875,52.35651,26501
911,zzhuang94,6,0.02264,13881,52.37916,26501
912,1134796031,5,0.01887,13886,52.39802,26501
913,4096j,5,0.01887,13891,52.41689,26501
914,AaronMegs,5,0.01887,13896,52.43576,26501
915,Abdallak2002,5,0.01887,13901,52.45462,26501
916,AbhishekTiwari23,5,0.01887,13906,52.47349,26501
917,Abinash-bit,5,0.01887,13911,52.49236,26501
918,adamisworking,5,0.01887,13916,52.51123,26501
919,adduali1310,5,0.01887,13921,52.53009,26501
920,aeitzman,5,0.01887,13926,52.54896,26501
921,airmelt,5,0.01887,13931,52.56783,26501
922,AKS74n,5,0.01887,13936,52.58669,26501
923,alnazaro,5,0.01887,13941,52.60556,26501
924,alok-aggarwal,5,0.01887,13946,52.62443,26501
925,Aloshi,5,0.01887,13951,52.64330,26501
926,amuart,5,0.01887,13956,52.66216,26501
927,anavarreteuk,5,0.01887,13961,52.68103,26501
928,andreacimino,5,0.01887,13966,52.69990,26501
929,andyjansson,5,0.01887,13971,52.71877,26501
930,ankitg-03,5,0.01887,13976,52.73763,26501
931,anubhav2212,5,0.01887,13981,52.75650,26501
932,aqaurius6666,5,0.01887,13986,52.77537,26501
933,argonotix,5,0.01887,13991,52.79423,26501
934,artemvmin,5,0.01887,13996,52.81310,26501
935,asadfaizi-github,5,0.01887,14001,52.83197,26501
936,ashwinexe,5,0.01887,14006,52.85084,26501
937,BarrensZeppelin,5,0.01887,14011,52.86970,26501
938,bbkxm,5,0.01887,14016,52.88857,26501
939,bc-sb,5,0.01887,14021,52.90744,26501
940,beilineili,5,0.01887,14026,52.92630,26501
941,ben-roling,5,0.01887,14031,52.94517,26501
942,billcarroll,5,0.01887,14036,52.96404,26501
943,bitmaybewise,5,0.01887,14041,52.98291,26501
944,bjlin888,5,0.01887,14046,53.00177,26501
945,bpholt,5,0.01887,14051,53.02064,26501
946,bradfair,5,0.01887,14056,53.03951,26501
947,Buduzz,5,0.01887,14061,53.05838,26501
948,budwing,5,0.01887,14066,53.07724,26501
949,builat,5,0.01887,14071,53.09611,26501
950,CaptainCplus,5,0.01887,14076,53.11498,26501
951,cfox-dev,5,0.01887,14081,53.13384,26501
952,charleshartiii,5,0.01887,14086,53.15271,26501
953,Charles-Johnson,5,0.01887,14091,53.17158,26501
954,chethan27,5,0.01887,14096,53.19045,26501
955,chusitoo,5,0.01887,14101,53.20931,26501
956,cmckeen,5,0.01887,14106,53.22818,26501
957,ContainerCheckpointfalse,5,0.01887,14111,53.24705,26501
958,correctzh,5,0.01887,14116,53.26591,26501
959,crimbler2,5,0.01887,14121,53.28478,26501
960,cuong-ts,5,0.01887,14126,53.30365,26501
961,cure53,5,0.01887,14131,53.32252,26501
962,daezaa,5,0.01887,14136,53.34138,26501
963,daniso123,5,0.01887,14141,53.36025,26501
964,Dash2701,5,0.01887,14146,53.37912,26501
965,dashahe,5,0.01887,14151,53.39798,26501
966,david-1990,5,0.01887,14156,53.41685,26501
967,davidcheng0922,5,0.01887,14161,53.43572,26501
968,davidifr,5,0.01887,14166,53.45459,26501
969,dazhao-msft,5,0.01887,14171,53.47345,26501
970,deepcyber,5,0.01887,14176,53.49232,26501
971,defims,5,0.01887,14181,53.51119,26501
972,Demcheck,5,0.01887,14186,53.53006,26501
973,Desiki-high,5,0.01887,14191,53.54892,26501
974,dhoizner,5,0.01887,14196,53.56779,26501
975,dmagala,5,0.01887,14201,53.58666,26501
976,doryer,5,0.01887,14206,53.60552,26501
977,dshebib,5,0.01887,14211,53.62439,26501
978,elauqsap,5,0.01887,14216,53.64326,26501
979,elmira-aliyeva,5,0.01887,14221,53.66213,26501
980,EnDimeonRus,5,0.01887,14226,53.68099,26501
981,Eternity-AIBN,5,0.01887,14231,53.69986,26501
982,Evilong,5,0.01887,14236,53.71873,26501
983,exgame,5,0.01887,14241,53.73759,26501
984,fabioformosa,5,0.01887,14246,53.75646,26501
985,fdingiit,5,0.01887,14251,53.77533,26501
986,FFengIll,5,0.01887,14256,53.79420,26501
987,fgleixner,5,0.01887,14261,53.81306,26501
988,Fredouye,5,0.01887,14266,53.83193,26501
989,fzwu,5,0.01887,14271,53.85080,26501
990,gaurav19063,5,0.01887,14276,53.86967,26501
991,giovanni-bertoncelli,5,0.01887,14281,53.88853,26501
992,gitanuj,5,0.01887,14286,53.90740,26501
993,Gobi-Ganesan,5,0.01887,14291,53.92627,26501
994,goodryanboy,5,0.01887,14296,53.94513,26501
995,gopower,5,0.01887,14301,53.96400,26501
996,gosharo,5,0.01887,14306,53.98287,26501
997,gosudvt,5,0.01887,14311,54.00174,26501
998,grkooij,5,0.01887,14316,54.02060,26501
999,ham1,5,0.01887,14321,54.03947,26501
1000,hannah-jj,5,0.01887,14326,54.05834,26501
1001,he323219002,5,0.01887,14331,54.07720,26501
1002,hellofengge,5,0.01887,14336,54.09607,26501
1003,hexiaofeng,5,0.01887,14341,54.11494,26501
1004,hhuahh,5,0.01887,14346,54.13381,26501
1005,hnougher,5,0.01887,14351,54.15267,26501
1006,hongyunyan,5,0.01887,14356,54.17154,26501
1007,hopkins516,5,0.01887,14361,54.19041,26501
1008,hrofiq,5,0.01887,14366,54.20928,26501
1009,HSoulat,5,0.01887,14371,54.22814,26501
1010,huangpx1,5,0.01887,14376,54.24701,26501
1011,husseinraoouf,5,0.01887,14381,54.26588,26501
1012,huynhj93,5,0.01887,14386,54.28474,26501
1013,Iapetus999,5,0.01887,14391,54.30361,26501
1014,idestis,5,0.01887,14396,54.32248,26501
1015,igor0,5,0.01887,14401,54.34135,26501
1016,imanushin,5,0.01887,14406,54.36021,26501
1017,ImNtReal,5,0.01887,14411,54.37908,26501
1018,ingeb0rga,5,0.01887,14416,54.39795,26501
1019,intelroman,5,0.01887,14421,54.41681,26501
1020,irwanshofwan,5,0.01887,14426,54.43568,26501
1021,isekiro,5,0.01887,14431,54.45455,26501
1022,Ishani-Gupta,5,0.01887,14436,54.47342,26501
1023,its07195,5,0.01887,14441,54.49228,26501
1024,jacobpella,5,0.01887,14446,54.51115,26501
1025,jaredzhou,5,0.01887,14451,54.53002,26501
1026,jasonjg,5,0.01887,14456,54.54888,26501
1027,javiermarasco,5,0.01887,14461,54.56775,26501
1028,Jeet-14,5,0.01887,14466,54.58662,26501
1029,Jeevananthan-23,5,0.01887,14471,54.60549,26501
1030,jethers,5,0.01887,14476,54.62435,26501
1031,jiaminglu,5,0.01887,14481,54.64322,26501
1032,jianshanyao,5,0.01887,14486,54.66209,26501
1033,jinguang-dong,5,0.01887,14491,54.68096,26501
1034,jlderidder,5,0.01887,14496,54.69982,26501
1035,JoeSpiral,5,0.01887,14501,54.71869,26501
1036,john-dev,5,0.01887,14506,54.73756,26501
1037,john-kajabi,5,0.01887,14511,54.75642,26501
1038,JonSobocinski,5,0.01887,14516,54.77529,26501
1039,jordanbreen28,5,0.01887,14521,54.79416,26501
1040,juhis135,5,0.01887,14526,54.81303,26501
1041,julian-labuschagne,5,0.01887,14531,54.83189,26501
1042,justapill,5,0.01887,14536,54.85076,26501
1043,kakashi96,5,0.01887,14541,54.86963,26501
1044,kanhaiya04,5,0.01887,14546,54.88849,26501
1045,karlcai1,5,0.01887,14551,54.90736,26501
1046,karolyc,5,0.01887,14556,54.92623,26501
1047,katul979,5,0.01887,14561,54.94510,26501
1048,KhurramShahzadODM,5,0.01887,14566,54.96396,26501
1049,kingkongpoon,5,0.01887,14571,54.98283,26501
1050,KinWaiYuen,5,0.01887,14576,55.00170,26501
1051,klucsik,5,0.01887,14581,55.02057,26501
1052,kosta,5,0.01887,14586,55.03943,26501
1053,KrasimirAntonov,5,0.01887,14591,55.05830,26501
1054,Kristories,5,0.01887,14596,55.07717,26501
1055,kumarjp,5,0.01887,14601,55.09603,26501
1056,kylebrooks-8451,5,0.01887,14606,55.11490,26501
1057,ldmid666,5,0.01887,14611,55.13377,26501
1058,ldpiuaeng,5,0.01887,14616,55.15264,26501
1059,liulei08,5,0.01887,14621,55.17150,26501
1060,llhed,5,0.01887,14626,55.19037,26501
1061,lucasalexsorensen,5,0.01887,14631,55.20924,26501
1062,lv88,5,0.01887,14636,55.22810,26501
1063,lzfhust,5,0.01887,14641,55.24697,26501
1064,m1k1o,5,0.01887,14646,55.26584,26501
1065,magelisk,5,0.01887,14651,55.28471,26501
1066,Mahadsid,5,0.01887,14656,55.30357,26501
1067,manav014,5,0.01887,14661,55.32244,26501
1068,mashuai191,5,0.01887,14666,55.34131,26501
1069,mathewpeterson,5,0.01887,14671,55.36018,26501
1070,mattzucker,5,0.01887,14676,55.37904,26501
1071,maxwellE,5,0.01887,14681,55.39791,26501
1072,Mayor-X,5,0.01887,14686,55.41678,26501
1073,MayXuQQ,5,0.01887,14691,55.43564,26501
1074,McPatate,5,0.01887,14696,55.45451,26501
1075,mdcurtis,5,0.01887,14701,55.47338,26501
1076,meyfa,5,0.01887,14706,55.49225,26501
1077,MichaelMorrisEst,5,0.01887,14711,55.51111,26501
1078,mihneaspirescu,5,0.01887,14716,55.52998,26501
1079,montag,5,0.01887,14721,55.54885,26501
1080,MrCoffey,5,0.01887,14726,55.56771,26501
1081,MrJW27,5,0.01887,14731,55.58658,26501
1082,naormalca,5,0.01887,14736,55.60545,26501
1083,narcoticfresh,5,0.01887,14741,55.62432,26501
1084,Naskitu,5,0.01887,14746,55.64318,26501
1085,Nathy5506,5,0.01887,14751,55.66205,26501
1086,navanitha-m,5,0.01887,14756,55.68092,26501
1087,neisw,5,0.01887,14761,55.69978,26501
1088,nickgreenspan,5,0.01887,14766,55.71865,26501
1089,NihalGoel,5,0.01887,14771,55.73752,26501
1090,nikodemjedynak-dnv,5,0.01887,14776,55.75639,26501
1091,nobuyo,5,0.01887,14781,55.77525,26501
1092,nugzarg,5,0.01887,14786,55.79412,26501
1093,ohbentos,5,0.01887,14791,55.81299,26501
1094,olekszhel,5,0.01887,14796,55.83186,26501
1095,olensmar,5,0.01887,14801,55.85072,26501
1096,panbanda,5,0.01887,14806,55.86959,26501
1097,pandel,5,0.01887,14811,55.88846,26501
1098,Paulskit,5,0.01887,14816,55.90732,26501
1099,peterhoneder,5,0.01887,14821,55.92619,26501
1100,peterpakos,5,0.01887,14826,55.94506,26501
1101,petersamueljohn,5,0.01887,14831,55.96393,26501
1102,phucnv282,5,0.01887,14836,55.98279,26501
1103,pkalvagit,5,0.01887,14841,56.00166,26501
1104,prestonr83,5,0.01887,14846,56.02053,26501
1105,psk001,5,0.01887,14851,56.03939,26501
1106,ptchau2003,5,0.01887,14856,56.05826,26501
1107,quaminigin,5,0.01887,14861,56.07713,26501
1108,rajbaratht,5,0.01887,14866,56.09600,26501
1109,rajharini,5,0.01887,14871,56.11486,26501
1110,ramekris3163,5,0.01887,14876,56.13373,26501
1111,reimgun,5,0.01887,14881,56.15260,26501
1112,renhuaihuai,5,0.01887,14886,56.17147,26501
1113,rickyyx,5,0.01887,14891,56.19033,26501
1114,rinat16,5,0.01887,14896,56.20920,26501
1115,rishisuresh7,5,0.01887,14901,56.22807,26501
1116,rmarasigan,5,0.01887,14906,56.24693,26501
1117,rnarkk,5,0.01887,14911,56.26580,26501
1118,robotadam,5,0.01887,14916,56.28467,26501
1119,Roohn,5,0.01887,14921,56.30354,26501
1120,ropsii,5,0.01887,14926,56.32240,26501
1121,sakurai-youhei,5,0.01887,14931,56.34127,26501
1122,santrancisco,5,0.01887,14936,56.36014,26501
1123,schrammm,5,0.01887,14941,56.37900,26501
1124,scotRinga-MayaDog,5,0.01887,14946,56.39787,26501
1125,seanduncandatadog,5,0.01887,14951,56.41674,26501
1126,seany89,5,0.01887,14956,56.43561,26501
1127,sgewirtz1,5,0.01887,14961,56.45447,26501
1128,shardulsr,5,0.01887,14966,56.47334,26501
1129,shashankbr11,5,0.01887,14971,56.49221,26501
1130,shashank-kavli,5,0.01887,14976,56.51108,26501
1131,shazib-summar,5,0.01887,14981,56.52994,26501
1132,Shiva19908,5,0.01887,14986,56.54881,26501
1133,Silthus,5,0.01887,14991,56.56768,26501
1134,simrankureel,5,0.01887,14996,56.58654,26501
1135,siriwatknp,5,0.01887,15001,56.60541,26501
1136,sirjasiu,5,0.01887,15006,56.62428,26501
1137,skreborn,5,0.01887,15011,56.64315,26501
1138,slacki123,5,0.01887,15016,56.66201,26501
1139,Sneha-at,5,0.01887,15021,56.68088,26501
1140,sno544,5,0.01887,15026,56.69975,26501
1141,soletan,5,0.01887,15031,56.71861,26501
1142,sonikro,5,0.01887,15036,56.73748,26501
1143,souraexx,5,0.01887,15041,56.75635,26501
1144,StopMotionCuber,5,0.01887,15046,56.77522,26501
1145,Sunny-001,5,0.01887,15051,56.79408,26501
1146,sunnyverma88,5,0.01887,15056,56.81295,26501
1147,surajgautam,5,0.01887,15061,56.83182,26501
1148,SusheelReddy00,5,0.01887,15066,56.85068,26501
1149,swasti29,5,0.01887,15071,56.86955,26501
1150,syang1997,5,0.01887,15076,56.88842,26501
1151,SzhiH,5,0.01887,15081,56.90729,26501
1152,talnevo,5,0.01887,15086,56.92615,26501
1153,talsharon48,5,0.01887,15091,56.94502,26501
1154,taoza,5,0.01887,15096,56.96389,26501
1155,tatashidayat,5,0.01887,15101,56.98276,26501
1156,Teresajw,5,0.01887,15106,57.00162,26501
1157,thani7k,5,0.01887,15111,57.02049,26501
1158,thomas-long-f3,5,0.01887,15116,57.03936,26501
1159,todd-liu,5,0.01887,15121,57.05822,26501
1160,tonychue,5,0.01887,15126,57.07709,26501
1161,toskanazawa,5,0.01887,15131,57.09596,26501
1162,trishnakalita660,5,0.01887,15136,57.11483,26501
1163,tsunche,5,0.01887,15141,57.13369,26501
1164,ultperf,5,0.01887,15146,57.15256,26501
1165,ValeryYegorov,5,0.01887,15151,57.17143,26501
1166,vazhnov,5,0.01887,15156,57.19029,26501
1167,vegerot,5,0.01887,15161,57.20916,26501
1168,vijayth,5,0.01887,15166,57.22803,26501
1169,wakeful,5,0.01887,15171,57.24690,26501
1170,wenting-guo,5,0.01887,15176,57.26576,26501
1171,wizpresso-steve-cy-fan,5,0.01887,15181,57.28463,26501
1172,wolfkor,5,0.01887,15186,57.30350,26501
1173,wuou-learn,5,0.01887,15191,57.32237,26501
1174,wusted,5,0.01887,15196,57.34123,26501
1175,wyatt-troia-msft,5,0.01887,15201,57.36010,26501
1176,xingming01,5,0.01887,15206,57.37897,26501
1177,yanghua,5,0.01887,15211,57.39783,26501
1178,yevhen-harmonizehr,5,0.01887,15216,57.41670,26501
1179,yicding,5,0.01887,15221,57.43557,26501
1180,yjabri,5,0.01887,15226,57.45444,26501
1181,ymwang7,5,0.01887,15231,57.47330,26501
1182,yoyehan,5,0.01887,15236,57.49217,26501
1183,yuweni99,5,0.01887,15241,57.51104,26501
1184,ZakMiller,5,0.01887,15246,57.52990,26501
1185,zewade,5,0.01887,15251,57.54877,26501
1186,zhangzhangzf,5,0.01887,15256,57.56764,26501
1187,Zizico2,5,0.01887,15261,57.58651,26501
1188,zohairraza,5,0.01887,15266,57.60537,26501
1189,0xdev22,4,0.01509,15270,57.62047,26501
1190,4TT1L4,4,0.01509,15274,57.63556,26501
1191,6u6i,4,0.01509,15278,57.65065,26501
1192,7309766,4,0.01509,15282,57.66575,26501
1193,aasyria,4,0.01509,15286,57.68084,26501
1194,Abdullah-alfadhel,4,0.01509,15290,57.69594,26501
1195,abramov-blink,4,0.01509,15294,57.71103,26501
1196,aburan28,4,0.01509,15298,57.72612,26501
1197,accursoft,4,0.01509,15302,57.74122,26501
1198,adefaria,4,0.01509,15306,57.75631,26501
1199,adityassharma-ss,4,0.01509,15310,57.77140,26501
1200,agarwalnit,4,0.01509,15314,57.78650,26501
1201,Ahmad-Faizan,4,0.01509,15318,57.80159,26501
1202,AidanGG,4,0.01509,15322,57.81669,26501
1203,AIFun,4,0.01509,15326,57.83178,26501
1204,akashhr7,4,0.01509,15330,57.84687,26501
1205,albertored,4,0.01509,15334,57.86197,26501
1206,alexo1088,4,0.01509,15338,57.87706,26501
1207,AlexPykavy,4,0.01509,15342,57.89216,26501
1208,Alex-ZL,4,0.01509,15346,57.90725,26501
1209,almasria,4,0.01509,15350,57.92234,26501
1210,Amitk3293,4,0.01509,15354,57.93744,26501
1211,AmrAlaaYassen,4,0.01509,15358,57.95253,26501
1212,amukherjeeupgrade,4,0.01509,15362,57.96762,26501
1213,andhesky,4,0.01509,15366,57.98272,26501
1214,AndiRudi,4,0.01509,15370,57.99781,26501
1215,annemirasol,4,0.01509,15374,58.01291,26501
1216,AnthonyDewhirst,4,0.01509,15378,58.02800,26501
1217,apuckey,4,0.01509,15382,58.04309,26501
1218,arcardon,4,0.01509,15386,58.05819,26501
1219,archeros-hmf,4,0.01509,15390,58.07328,26501
1220,arluko,4,0.01509,15394,58.08837,26501
1221,arnaudclerc,4,0.01509,15398,58.10347,26501
1222,aroenK,4,0.01509,15402,58.11856,26501
1223,atiwari-cloudera,4,0.01509,15406,58.13366,26501
1224,auchynnikau,4,0.01509,15410,58.14875,26501
1225,auxworker,4,0.01509,15414,58.16384,26501
1226,b0id,4,0.01509,15418,58.17894,26501
1227,baerwang,4,0.01509,15422,58.19403,26501
1228,baptiste-gaillet,4,0.01509,15426,58.20912,26501
1229,bashor,4,0.01509,15430,58.22422,26501
1230,basvs,4,0.01509,15434,58.23931,26501
1231,bbkz,4,0.01509,15438,58.25441,26501
1232,bboyadao,4,0.01509,15442,58.26950,26501
1233,bharatbandu1,4,0.01509,15446,58.28459,26501
1234,bherbst,4,0.01509,15450,58.29969,26501
1235,bittracer,4,0.01509,15454,58.31478,26501
1236,black-snow,4,0.01509,15458,58.32987,26501
1237,bofeng96,4,0.01509,15462,58.34497,26501
1238,bolwie,4,0.01509,15466,58.36006,26501
1239,borgiacis,4,0.01509,15470,58.37516,26501
1240,brainsky,4,0.01509,15474,58.39025,26501
1241,brodier,4,0.01509,15478,58.40534,26501
1242,BRONSOLO,4,0.01509,15482,58.42044,26501
1243,bsloan-icl,4,0.01509,15486,58.43553,26501
1244,bvehse,4,0.01509,15490,58.45062,26501
1245,calebROlson,4,0.01509,15494,58.46572,26501
1246,cannfoddr,4,0.01509,15498,58.48081,26501
1247,CarlosGuemS,4,0.01509,15502,58.49591,26501
1248,cbi-at-varian,4,0.01509,15506,58.51100,26501
1249,c-cube,4,0.01509,15510,58.52609,26501
1250,cgowdacn,4,0.01509,15514,58.54119,26501
1251,ChaiNikhilShinde,4,0.01509,15518,58.55628,26501
1252,chaitanyabisht,4,0.01509,15522,58.57137,26501
1253,chewbacca9000,4,0.01509,15526,58.58647,26501
1254,chiomaT,4,0.01509,15530,58.60156,26501
1255,Chiraguthra,4,0.01509,15534,58.61666,26501
1256,Choon38,4,0.01509,15538,58.63175,26501
1257,chris-codeflow,4,0.01509,15542,58.64684,26501
1258,christophe-calmejane,4,0.01509,15546,58.66194,26501
1259,chw120,4,0.01509,15550,58.67703,26501
1260,claytonwohl,4,0.01509,15554,58.69212,26501
1261,corentin-pasquier,4,0.01509,15558,58.70722,26501
1262,correialabbate,4,0.01509,15562,58.72231,26501
1263,dairta,4,0.01509,15566,58.73741,26501
1264,dakraus,4,0.01509,15570,58.75250,26501
1265,dandan3o3,4,0.01509,15574,58.76759,26501
1266,danielluke,4,0.01509,15578,58.78269,26501
1267,darvay,4,0.01509,15582,58.79778,26501
1268,datacore-vvarakantham,4,0.01509,15586,58.81287,26501
1269,dbragdon1,4,0.01509,15590,58.82797,26501
1270,dbrattli,4,0.01509,15594,58.84306,26501
1271,dcillera,4,0.01509,15598,58.85816,26501
1272,Deep-Yellow,4,0.01509,15602,58.87325,26501
1273,dgcaron,4,0.01509,15606,58.88834,26501
1274,dhw362177,4,0.01509,15610,58.90344,26501
1275,DimpleRajaVamsi,4,0.01509,15614,58.91853,26501
1276,djessich,4,0.01509,15618,58.93363,26501
1277,dkondidatov,4,0.01509,15622,58.94872,26501
1278,dlydiard,4,0.01509,15626,58.96381,26501
1279,dmittelstaedt,4,0.01509,15630,58.97891,26501
1280,dnelson-relativity,4,0.01509,15634,58.99400,26501
1281,dollopofsunshine,4,0.01509,15638,59.00909,26501
1282,dondsouza,4,0.01509,15642,59.02419,26501
1283,dspo,4,0.01509,15646,59.03928,26501
1284,dtopdontstop,4,0.01509,15650,59.05438,26501
1285,Dundonis,4,0.01509,15654,59.06947,26501
1286,eddie-huhu,4,0.01509,15658,59.08456,26501
1287,efenner-cambia,4,0.01509,15662,59.09966,26501
1288,eladh,4,0.01509,15666,59.11475,26501
1289,eliad-wiz,4,0.01509,15670,59.12984,26501
1290,emilio-cea,4,0.01509,15674,59.14494,26501
1291,erxiaozhou,4,0.01509,15678,59.16003,26501
1292,eshikafe,4,0.01509,15682,59.17513,26501
1293,EugeneMospan,4,0.01509,15686,59.19022,26501
1294,eugen-fried,4,0.01509,15690,59.20531,26501
1295,fahab0b,4,0.01509,15694,59.22041,26501
1296,faide,4,0.01509,15698,59.23550,26501
1297,fclesio,4,0.01509,15702,59.25059,26501
1298,feisc,4,0.01509,15706,59.26569,26501
1299,Ferdbugs,4,0.01509,15710,59.28078,26501
1300,FlorianJDF,4,0.01509,15714,59.29588,26501
1301,Freia3,4,0.01509,15718,59.31097,26501
1302,gabriel-doriath-dohler,4,0.01509,15722,59.32606,26501
1303,gabrielpvbw,4,0.01509,15726,59.34116,26501
1304,gaetanquentin,4,0.01509,15730,59.35625,26501
1305,garutilorenzo,4,0.01509,15734,59.37134,26501
1306,ggallotti,4,0.01509,15738,59.38644,26501
1307,GhangZh,4,0.01509,15742,59.40153,26501
1308,giraone,4,0.01509,15746,59.41663,26501
1309,gmeher,4,0.01509,15750,59.43172,26501
1310,gmslabs,4,0.01509,15754,59.44681,26501
1311,gnewton,4,0.01509,15758,59.46191,26501
1312,Godfunc,4,0.01509,15762,59.47700,26501
1313,gojanpaolo,4,0.01509,15766,59.49209,26501
1314,gosavip,4,0.01509,15770,59.50719,26501
1315,griesd,4,0.01509,15774,59.52228,26501
1316,gt814,4,0.01509,15778,59.53738,26501
1317,gursimarsm,4,0.01509,15782,59.55247,26501
1318,guyue66,4,0.01509,15786,59.56756,26501
1319,gvd22,4,0.01509,15790,59.58266,26501
1320,Gzy1112,4,0.01509,15794,59.59775,26501
1321,Ha-Dj,4,0.01509,15798,59.61284,26501
1322,hajdukda,4,0.01509,15802,59.62794,26501
1323,hauks96,4,0.01509,15806,59.64303,26501
1324,hejingkan2005,4,0.01509,15810,59.65813,26501
1325,helloimalastair,4,0.01509,15814,59.67322,26501
1326,hendrikebbers,4,0.01509,15818,59.68831,26501
1327,henkuaifacai,4,0.01509,15822,59.70341,26501
1328,henryzhao95,4,0.01509,15826,59.71850,26501
1329,huaxk,4,0.01509,15830,59.73359,26501
1330,igstbagusdharmaputra,4,0.01509,15834,59.74869,26501
1331,Intecpsp,4,0.01509,15838,59.76378,26501
1332,InTheCage,4,0.01509,15842,59.77888,26501
1333,ipl31,4,0.01509,15846,59.79397,26501
1334,iqbalsound,4,0.01509,15850,59.80906,26501
1335,iulspop,4,0.01509,15854,59.82416,26501
1336,ivasilyev-servicetitan-com,4,0.01509,15858,59.83925,26501
1337,jameswoodley,4,0.01509,15862,59.85435,26501
1338,Jamsa,4,0.01509,15866,59.86944,26501
1339,Jarvif,4,0.01509,15870,59.88453,26501
1340,JayKus,4,0.01509,15874,59.89963,26501
1341,JBodkin,4,0.01509,15878,59.91472,26501
1342,Jean-Marc-Le-Fevre,4,0.01509,15882,59.92981,26501
1343,Jelly-Fisher-fish,4,0.01509,15886,59.94491,26501
1344,jensjohansen,4,0.01509,15890,59.96000,26501
1345,jerrybowman,4,0.01509,15894,59.97510,26501
1346,jessegonzalez-life360,4,0.01509,15898,59.99019,26501
1347,jesusfcr,4,0.01509,15902,60.00528,26501
1348,jfefes,4,0.01509,15906,60.02038,26501
1349,JgardemeRelex,4,0.01509,15910,60.03547,26501
1350,jiangjianshan,4,0.01509,15914,60.05056,26501
1351,jimitkr,4,0.01509,15918,60.06566,26501
1352,jimmyforrest,4,0.01509,15922,60.08075,26501
1353,jkgenser,4,0.01509,15926,60.09585,26501
1354,jlubawy,4,0.01509,15930,60.11094,26501
1355,jnytnai0613,4,0.01509,15934,60.12603,26501
1356,joeltraber,4,0.01509,15938,60.14113,26501
1357,jomadu,4,0.01509,15942,60.15622,26501
1358,JonathanDoelan,4,0.01509,15946,60.17131,26501
1359,joodlehammond,4,0.01509,15950,60.18641,26501
1360,JoseOcampoDw,4,0.01509,15954,60.20150,26501
1361,joshua-baron,4,0.01509,15958,60.21660,26501
1362,jpcosal,4,0.01509,15962,60.23169,26501
1363,jsbrain,4,0.01509,15966,60.24678,26501
1364,jseutter,4,0.01509,15970,60.26188,26501
1365,jtreher,4,0.01509,15974,60.27697,26501
1366,julienfouilhe,4,0.01509,15978,60.29206,26501
1367,junfsir,4,0.01509,15982,60.30716,26501
1368,kalduzov,4,0.01509,15986,60.32225,26501
1369,kdarw,4,0.01509,15990,60.33735,26501
1370,kealanodoherty,4,0.01509,15994,60.35244,26501
1371,kevburnsjr,4,0.01509,15998,60.36753,26501
1372,kevinneville,4,0.01509,16002,60.38263,26501
1373,kgrafico,4,0.01509,16006,60.39772,26501
1374,kmathewmk,4,0.01509,16010,60.41281,26501
1375,ktnrn,4,0.01509,16014,60.42791,26501
1376,ktsowes,4,0.01509,16018,60.44300,26501
1377,kuberlog,4,0.01509,16022,60.45810,26501
1378,kuppuswamy,4,0.01509,16026,60.47319,26501
1379,kuzmavictor,4,0.01509,16030,60.48828,26501
1380,kwaberski,4,0.01509,16034,60.50338,26501
1381,kyblik,4,0.01509,16038,60.51847,26501
1382,Lady-Summer,4,0.01509,16042,60.53356,26501
1383,laughingman7743,4,0.01509,16046,60.54866,26501
1384,leexx227,4,0.01509,16050,60.56375,26501
1385,lennybacon,4,0.01509,16054,60.57885,26501
1386,Leshii82,4,0.01509,16058,60.59394,26501
1387,liry,4,0.01509,16062,60.60903,26501
1388,louishlz,4,0.01509,16066,60.62413,26501
1389,LUEDDEA,4,0.01509,16070,60.63922,26501
1390,luvsaxena1,4,0.01509,16074,60.65431,26501
1391,mahi072,4,0.01509,16078,60.66941,26501
1392,mahmoudajawad,4,0.01509,16082,60.68450,26501
1393,MansurEsm,4,0.01509,16086,60.69960,26501
1394,Manu-DF,4,0.01509,16090,60.71469,26501
1395,marcelfranca,4,0.01509,16094,60.72978,26501
1396,marre,4,0.01509,16098,60.74488,26501
1397,MartinDeLaTorre,4,0.01509,16102,60.75997,26501
1398,martinflemingdev,4,0.01509,16106,60.77507,26501
1399,martino-zito,4,0.01509,16110,60.79016,26501
1400,masifeddress,4,0.01509,16114,60.80525,26501
1401,Mattieeec3,4,0.01509,16118,60.82035,26501
1402,mattspataro,4,0.01509,16122,60.83544,26501
1403,maurice-freitag,4,0.01509,16126,60.85053,26501
1404,mayilian,4,0.01509,16130,60.86563,26501
1405,mconrejas,4,0.01509,16134,60.88072,26501
1406,Mehdimome,4,0.01509,16138,60.89582,26501
1407,mgzenitech,4,0.01509,16142,60.91091,26501
1408,michalg91,4,0.01509,16146,60.92600,26501
1409,MichalKosowski,4,0.01509,16150,60.94110,26501
1410,michizubi-SRF,4,0.01509,16154,60.95619,26501
1411,Mihai-CMM,4,0.01509,16158,60.97128,26501
1412,mikekwabs,4,0.01509,16162,60.98638,26501
1413,MikeSamv,4,0.01509,16166,61.00147,26501
1414,mirakladp,4,0.01509,16170,61.01657,26501
1415,mkzpd,4,0.01509,16174,61.03166,26501
1416,mockdeep,4,0.01509,16178,61.04675,26501
1417,money8203,4,0.01509,16182,61.06185,26501
1418,moria97,4,0.01509,16186,61.07694,26501
1419,morzhanov,4,0.01509,16190,61.09203,26501
1420,mpatlasov,4,0.01509,16194,61.10713,26501
1421,mq2195,4,0.01509,16198,61.12222,26501
1422,mrequena,4,0.01509,16202,61.13732,26501
1423,muhammadnmuhammad01,4,0.01509,16206,61.15241,26501
1424,mumeraltaf,4,0.01509,16210,61.16750,26501
1425,myles2007,4,0.01509,16214,61.18260,26501
1426,nayea222387,4,0.01509,16218,61.19769,26501
1427,ndrafahl,4,0.01509,16222,61.21278,26501
1428,Neeraj-Natu,4,0.01509,16226,61.22788,26501
1429,neha-Gupta1,4,0.01509,16230,61.24297,26501
1430,neogopher,4,0.01509,16234,61.25807,26501
1431,NetDevDewm,4,0.01509,16238,61.27316,26501
1432,ngokchaoho,4,0.01509,16242,61.28825,26501
1433,nickbeaugie,4,0.01509,16246,61.30335,26501
1434,NickOttrando,4,0.01509,16250,61.31844,26501
1435,nigelgbanks,4,0.01509,16254,61.33353,26501
1436,Nikhils09,4,0.01509,16258,61.34863,26501
1437,nineunderground,4,0.01509,16262,61.36372,26501
1438,nirmalg-1454,4,0.01509,16266,61.37882,26501
1439,nishantsikarwar,4,0.01509,16270,61.39391,26501
1440,nkuacac,4,0.01509,16274,61.40900,26501
1441,no-cool-name,4,0.01509,16278,61.42410,26501
1442,NonsoAmadi10,4,0.01509,16282,61.43919,26501
1443,novoj,4,0.01509,16286,61.45428,26501
1444,nulllpoint,4,0.01509,16290,61.46938,26501
1445,OkkeHendriks,4,0.01509,16294,61.48447,26501
1446,onetwopunch,4,0.01509,16298,61.49957,26501
1447,patrickfreed,4,0.01509,16302,61.51466,26501
1448,pawmaster,4,0.01509,16306,61.52975,26501
1449,pbrzoska-sumo,4,0.01509,16310,61.54485,26501
1450,pcperera,4,0.01509,16314,61.55994,26501
1451,PedroAlbamonte,4,0.01509,16318,61.57503,26501
1452,PengLingJun,4,0.01509,16322,61.59013,26501
1453,pengln,4,0.01509,16326,61.60522,26501
1454,peterjamesgrant,4,0.01509,16330,61.62032,26501
1455,petr-buchyn,4,0.01509,16334,61.63541,26501
1456,PetrusZ,4,0.01509,16338,61.65050,26501
1457,phoenixsqf,4,0.01509,16342,61.66560,26501
1458,phpmaple,4,0.01509,16346,61.68069,26501
1459,Piet2001,4,0.01509,16350,61.69579,26501
1460,ppbits,4,0.01509,16354,61.71088,26501
1461,pranab19sah99,4,0.01509,16358,61.72597,26501
1462,pratapgowda007,4,0.01509,16362,61.74107,26501
1463,Preeti0512,4,0.01509,16366,61.75616,26501
1464,procinger,4,0.01509,16370,61.77125,26501
1465,psancheti110,4,0.01509,16374,61.78635,26501
1466,psi,4,0.01509,16378,61.80144,26501
1467,q7r,4,0.01509,16382,61.81654,26501
1468,quentinlacrouts,4,0.01509,16386,61.83163,26501
1469,quertenmont,4,0.01509,16390,61.84672,26501
1470,quyenhoang96,4,0.01509,16394,61.86182,26501
1471,rabbanirizwan,4,0.01509,16398,61.87691,26501
1472,radekfojtik,4,0.01509,16402,61.89200,26501
1473,RahulGopathi,4,0.01509,16406,61.90710,26501
1474,RakeshAMD,4,0.01509,16410,61.92219,26501
1475,ralonsoh,4,0.01509,16414,61.93729,26501
1476,ravilanda,4,0.01509,16418,61.95238,26501
1477,RetGal,4,0.01509,16422,61.96747,26501
1478,returntrip,4,0.01509,16426,61.98257,26501
1479,rguilmont,4,0.01509,16430,61.99766,26501
1480,rijuvfrancis,4,0.01509,16434,62.01275,26501
1481,Rishav1707,4,0.01509,16438,62.02785,26501
1482,rixongary,4,0.01509,16442,62.04294,26501
1483,RiyaAbhishek,4,0.01509,16446,62.05804,26501
1484,rkscodes,4,0.01509,16450,62.07313,26501
1485,rluvaton,4,0.01509,16454,62.08822,26501
1486,RobertWojtowicz,4,0.01509,16458,62.10332,26501
1487,rogerrum,4,0.01509,16462,62.11841,26501
1488,RogerSik,4,0.01509,16466,62.13350,26501
1489,rohank07,4,0.01509,16470,62.14860,26501
1490,RomanPavelko,4,0.01509,16474,62.16369,26501
1491,RomanTheLegend,4,0.01509,16478,62.17879,26501
1492,rootrahulagr,4,0.01509,16482,62.19388,26501
1493,RyanStan,4,0.01509,16486,62.20897,26501
1494,S0n98,4,0.01509,16490,62.22407,26501
1495,sahnib,4,0.01509,16494,62.23916,26501
1496,saifshaikh48,4,0.01509,16498,62.25425,26501
1497,saimadhav2k2,4,0.01509,16502,62.26935,26501
1498,samascience,4,0.01509,16506,62.28444,26501
1499,saneryao,4,0.01509,16510,62.29954,26501
1500,Sangeppato,4,0.01509,16514,62.31463,26501
1501,Sansar146,4,0.01509,16518,62.32972,26501
1502,sayo11021,4,0.01509,16522,62.34482,26501
1503,sbonds,4,0.01509,16526,62.35991,26501
1504,scholarsmate,4,0.01509,16530,62.37500,26501
1505,scrungus,4,0.01509,16534,62.39010,26501
1506,scv119,4,0.01509,16538,62.40519,26501
1507,sdrik,4,0.01509,16542,62.42029,26501
1508,sergeybrazhnik-cb,4,0.01509,16546,62.43538,26501
1509,shanduur-dell,4,0.01509,16550,62.45047,26501
1510,ShouEnHsiao,4,0.01509,16554,62.46557,26501
1511,shuvo072,4,0.01509,16558,62.48066,26501
1512,sidmohanty11,4,0.01509,16562,62.49575,26501
1513,sinloss,4,0.01509,16566,62.51085,26501
1514,siwyroot,4,0.01509,16570,62.52594,26501
1515,skolosov-snap,4,0.01509,16574,62.54104,26501
1516,skuijper,4,0.01509,16578,62.55613,26501
1517,sl45sms,4,0.01509,16582,62.57122,26501
1518,snej,4,0.01509,16586,62.58632,26501
1519,spnngl,4,0.01509,16590,62.60141,26501
1520,SrDayne,4,0.01509,16594,62.61651,26501
1521,ssccinng,4,0.01509,16598,62.63160,26501
1522,stemar94,4,0.01509,16602,62.64669,26501
1523,StevenYuanyuan,4,0.01509,16606,62.66179,26501
1524,stricklandye,4,0.01509,16610,62.67688,26501
1525,stvleung,4,0.01509,16614,62.69197,26501
1526,sunhao1256,4,0.01509,16618,62.70707,26501
1527,sunnyzhy,4,0.01509,16622,62.72216,26501
1528,surdaft,4,0.01509,16626,62.73726,26501
1529,swarna1101,4,0.01509,16630,62.75235,26501
1530,Tan-JiaLiang,4,0.01509,16634,62.76744,26501
1531,tariksimsek,4,0.01509,16638,62.78254,26501
1532,tb137,4,0.01509,16642,62.79763,26501
1533,TBragi,4,0.01509,16646,62.81272,26501
1534,tcohen01,4,0.01509,16650,62.82782,26501
1535,Tejeswarreddy-3i,4,0.01509,16654,62.84291,26501
1536,teobmg,4,0.01509,16658,62.85801,26501
1537,thatvmwareguy,4,0.01509,16662,62.87310,26501
1538,TheCarpetMerchant,4,0.01509,16666,62.88819,26501
1539,theguy159,4,0.01509,16670,62.90329,26501
1540,TheJacobWalters,4,0.01509,16674,62.91838,26501
1541,TheNomet,4,0.01509,16678,62.93347,26501
1542,TheOneTheOnlyJJ,4,0.01509,16682,62.94857,26501
1543,TheRealSibasishBehera,4,0.01509,16686,62.96366,26501
1544,thereisnotime,4,0.01509,16690,62.97876,26501
1545,thomaszub,4,0.01509,16694,62.99385,26501
1546,thousmile,4,0.01509,16698,63.00894,26501
1547,tillkruss,4,0.01509,16702,63.02404,26501
1548,timmygrable,4,0.01509,16706,63.03913,26501
1549,tobiasehlert,4,0.01509,16710,63.05422,26501
1550,tomasgiden,4,0.01509,16714,63.06932,26501
1551,torpare,4,0.01509,16718,63.08441,26501
1552,trgeiger,4,0.01509,16722,63.09951,26501
1553,triadcode,4,0.01509,16726,63.11460,26501
1554,tsinan,4,0.01509,16730,63.12969,26501
1555,tunnelshade,4,0.01509,16734,63.14479,26501
1556,tuxicorn,4,0.01509,16738,63.15988,26501
1557,tydic-com,4,0.01509,16742,63.17497,26501
1558,tyu0912,4,0.01509,16746,63.19007,26501
1559,umutsahin,4,0.01509,16750,63.20516,26501
1560,UnoSD,4,0.01509,16754,63.22026,26501
1561,varunagarwal315,4,0.01509,16758,63.23535,26501
1562,vikrantoct7,4,0.01509,16762,63.25044,26501
1563,vipulp86,4,0.01509,16766,63.26554,26501
1564,vitalii-buchyn-exa,4,0.01509,16770,63.28063,26501
1565,vizeit,4,0.01509,16774,63.29572,26501
1566,vlkv,4,0.01509,16778,63.31082,26501
1567,vmw-yingy,4,0.01509,16782,63.32591,26501
1568,vpandeti,4,0.01509,16786,63.34101,26501
1569,vparv,4,0.01509,16790,63.35610,26501
1570,vpuliyal,4,0.01509,16794,63.37119,26501
1571,vroldanbet,4,0.01509,16798,63.38629,26501
1572,waqarsky,4,0.01509,16802,63.40138,26501
1573,wendyfatcat,4,0.01509,16806,63.41647,26501
1574,wigust,4,0.01509,16810,63.43157,26501
1575,wilief,4,0.01509,16814,63.44666,26501
1576,Wld1122,4,0.01509,16818,63.46176,26501
1577,woutergd,4,0.01509,16822,63.47685,26501
1578,xdatcloud,4,0.01509,16826,63.49194,26501
1579,xidian237,4,0.01509,16830,63.50704,26501
1580,XiongKezhi,4,0.01509,16834,63.52213,26501
1581,XMingG99,4,0.01509,16838,63.53723,26501
1582,yangbobo6,4,0.01509,16842,63.55232,26501
1583,Yang-QW,4,0.01509,16846,63.56741,26501
1584,yangyulele,4,0.01509,16850,63.58251,26501
1585,yashdev9274,4,0.01509,16854,63.59760,26501
1586,yashp1402,4,0.01509,16858,63.61269,26501
1587,yas-khan,4,0.01509,16862,63.62779,26501
1588,yfge,4,0.01509,16866,63.64288,26501
1589,yk-zheng-zz,4,0.01509,16870,63.65798,26501
1590,yoav-melamed,4,0.01509,16874,63.67307,26501
1591,yodobrin,4,0.01509,16878,63.68816,26501
1592,yossi77,4,0.01509,16882,63.70326,26501
1593,yrs147,4,0.01509,16886,63.71835,26501
1594,zedgell,4,0.01509,16890,63.73344,26501
1595,zelig81,4,0.01509,16894,63.74854,26501
1596,zhaixiaojuan,4,0.01509,16898,63.76363,26501
1597,zhiltsov-max,4,0.01509,16902,63.77873,26501
1598,zhouyq9001,4,0.01509,16906,63.79382,26501
1599,zuige970126,4,0.01509,16910,63.80891,26501
1600,zyb521,4,0.01509,16914,63.82401,26501
1601,155cannon,3,0.01132,16917,63.83533,26501
1602,40107854,3,0.01132,16920,63.84665,26501
1603,467892746,3,0.01132,16923,63.85797,26501
1604,501658362,3,0.01132,16926,63.86929,26501
1605,5StevenWu,3,0.01132,16929,63.88061,26501
1606,a497134710,3,0.01132,16932,63.89193,26501
1607,aadi58002,3,0.01132,16935,63.90325,26501
1608,aalexandrov,3,0.01132,16938,63.91457,26501
1609,aashishgaba-cn,3,0.01132,16941,63.92589,26501
1610,aayush1205,3,0.01132,16944,63.93721,26501
1611,abbyssoul,3,0.01132,16947,63.94853,26501
1612,abdulhubbali,3,0.01132,16950,63.95985,26501
1613,abel408,3,0.01132,16953,63.97117,26501
1614,abracadabra-aaa,3,0.01132,16956,63.98249,26501
1615,aburgos-hv,3,0.01132,16959,63.99381,26501
1616,adejongh93,3,0.01132,16962,64.00513,26501
1617,adiazcan,3,0.01132,16965,64.01645,26501
1618,AdityaVallabh,3,0.01132,16968,64.02777,26501
1619,AdriaGS,3,0.01132,16971,64.03909,26501
1620,adriancast,3,0.01132,16974,64.05041,26501
1621,adriansr,3,0.01132,16977,64.06173,26501
1622,aesophor,3,0.01132,16980,64.07305,26501
1623,AfroSpartan,3,0.01132,16983,64.08437,26501
1624,agagniere,3,0.01132,16986,64.09569,26501
1625,agoodwin,3,0.01132,16989,64.10701,26501
1626,agramner,3,0.01132,16992,64.11834,26501
1627,AHulshoff,3,0.01132,16995,64.12966,26501
1628,ailunbolinkenasi,3,0.01132,16998,64.14098,26501
1629,airtower-luna,3,0.01132,17001,64.15230,26501
1630,ajcts,3,0.01132,17004,64.16362,26501
1631,akash-yadagouda,3,0.01132,17007,64.17494,26501
1632,aknot242,3,0.01132,17010,64.18626,26501
1633,akshat-zopsmart,3,0.01132,17013,64.19758,26501
1634,akwodkiewicz,3,0.01132,17016,64.20890,26501
1635,alamoot,3,0.01132,17019,64.22022,26501
1636,alandavidreyes,3,0.01132,17022,64.23154,26501
1637,alexakra,3,0.01132,17025,64.24286,26501
1638,alexander-deb,3,0.01132,17028,64.25418,26501
1639,alexandre-mendes,3,0.01132,17031,64.26550,26501
1640,alexandrempm,3,0.01132,17034,64.27682,26501
1641,AlexisZam,3,0.01132,17037,64.28814,26501
1642,AlfonsoCiampaNTT,3,0.01132,17040,64.29946,26501
1643,alfredwkh,3,0.01132,17043,64.31078,26501
1644,algebrajones,3,0.01132,17046,64.32210,26501
1645,alik42,3,0.01132,17049,64.33342,26501
1646,alloveras,3,0.01132,17052,64.34474,26501
1647,allyford,3,0.01132,17055,64.35606,26501
1648,AlonMaor14,3,0.01132,17058,64.36738,26501
1649,Aman1919,3,0.01132,17061,64.37870,26501
1650,AmarNathChary,3,0.01132,17064,64.39002,26501
1651,amiozzo,3,0.01132,17067,64.40134,26501
1652,amirbilu,3,0.01132,17070,64.41266,26501
1653,amnamek,3,0.01132,17073,64.42398,26501
1654,amolkavitkar,3,0.01132,17076,64.43530,26501
1655,Amritprakash2704,3,0.01132,17079,64.44662,26501
1656,amthorn,3,0.01132,17082,64.45794,26501
1657,anandarajr,3,0.01132,17085,64.46927,26501
1658,anandfresh,3,0.01132,17088,64.48059,26501
1659,andi-blafasl,3,0.01132,17091,64.49191,26501
1660,andreadistefano,3,0.01132,17094,64.50323,26501
1661,AndreasPrang,3,0.01132,17097,64.51455,26501
1662,andy-js,3,0.01132,17100,64.52587,26501
1663,andyste1,3,0.01132,17103,64.53719,26501
1664,AnirudhBot,3,0.01132,17106,64.54851,26501
1665,ankit28pandey,3,0.01132,17109,64.55983,26501
1666,ankit-arora-369,3,0.01132,17112,64.57115,26501
1667,anonymouspage,3,0.01132,17115,64.58247,26501
1668,AnshulAngaria,3,0.01132,17118,64.59379,26501
1669,AnshumanPadiya,3,0.01132,17121,64.60511,26501
1670,antoniosi,3,0.01132,17124,64.61643,26501
1671,antonydevanchi,3,0.01132,17127,64.62775,26501
1672,apo-ger,3,0.01132,17130,64.63907,26501
1673,aries1998,3,0.01132,17133,64.65039,26501
1674,arkadipdigite,3,0.01132,17136,64.66171,26501
1675,arlando,3,0.01132,17139,64.67303,26501
1676,armed,3,0.01132,17142,64.68435,26501
1677,arnthor89,3,0.01132,17145,64.69567,26501
1678,arshashi,3,0.01132,17148,64.70699,26501
1679,artem-zherdiev-ingio,3,0.01132,17151,64.71831,26501
1680,asajoshi,3,0.01132,17154,64.72963,26501
1681,aschi1,3,0.01132,17157,64.74095,26501
1682,AshfaqurIntel,3,0.01132,17160,64.75227,26501
1683,a-skuba,3,0.01132,17163,64.76359,26501
1684,asura-asp,3,0.01132,17166,64.77491,26501
1685,Atticuss,3,0.01132,17169,64.78623,26501
1686,aunikitin,3,0.01132,17172,64.79755,26501
1687,avereshchak,3,0.01132,17175,64.80888,26501
1688,avikt18,3,0.01132,17178,64.82020,26501
1689,avmuduluru,3,0.01132,17181,64.83152,26501
1690,awwwd,3,0.01132,17184,64.84284,26501
1691,Azhovan,3,0.01132,17187,64.85416,26501
1692,baigod,3,0.01132,17190,64.86548,26501
1693,BalajiVijayakumar1195,3,0.01132,17193,64.87680,26501
1694,bastiaanv,3,0.01132,17196,64.88812,26501
1695,batusekerci,3,0.01132,17199,64.89944,26501
1696,benediktberger,3,0.01132,17202,64.91076,26501
1697,BenyuXu,3,0.01132,17205,64.92208,26501
1698,berryq460,3,0.01132,17208,64.93340,26501
1699,bfeher-kx,3,0.01132,17211,64.94472,26501
1700,b-freitas,3,0.01132,17214,64.95604,26501
1701,bigdavethewave,3,0.01132,17217,64.96736,26501
1702,big-thousand,3,0.01132,17220,64.97868,26501
1703,bkranendonk,3,0.01132,17223,64.99000,26501
1704,BlaBlaGITTE,3,0.01132,17226,65.00132,26501
1705,BlackJohnny,3,0.01132,17229,65.01264,26501
1706,Black-Rum,3,0.01132,17232,65.02396,26501
1707,bnjns,3,0.01132,17235,65.03528,26501
1708,Bob343,3,0.01132,17238,65.04660,26501
1709,boblodgett,3,0.01132,17241,65.05792,26501
1710,boedy,3,0.01132,17244,65.06924,26501
1711,boosterl,3,0.01132,17247,65.08056,26501
1712,brammulders,3,0.01132,17250,65.09188,26501
1713,brentpetit-hpe,3,0.01132,17253,65.10320,26501
1714,bricksky,3,0.01132,17256,65.11452,26501
1715,burakkantarci,3,0.01132,17259,65.12584,26501
1716,buzzerpuzzle,3,0.01132,17262,65.13716,26501
1717,bvaturi,3,0.01132,17265,65.14848,26501
1718,By-Accident,3,0.01132,17268,65.15981,26501
1719,ByteYue,3,0.01132,17271,65.17113,26501
1720,c00kie123,3,0.01132,17274,65.18245,26501
1721,caerulescens,3,0.01132,17277,65.19377,26501
1722,caioq,3,0.01132,17280,65.20509,26501
1723,caixiangibm,3,0.01132,17283,65.21641,26501
1724,CaiYueTing,3,0.01132,17286,65.22773,26501
1725,carbonshow,3,0.01132,17289,65.23905,26501
1726,carlwang87,3,0.01132,17292,65.25037,26501
1727,cbatson,3,0.01132,17295,65.26169,26501
1728,ceich,3,0.01132,17298,65.27301,26501
1729,CEO-CGS,3,0.01132,17301,65.28433,26501
1730,ch629,3,0.01132,17304,65.29565,26501
1731,chacond,3,0.01132,17307,65.30697,26501
1732,chaitanya1731,3,0.01132,17310,65.31829,26501
1733,chalharu,3,0.01132,17313,65.32961,26501
1734,chandan-srm,3,0.01132,17316,65.34093,26501
1735,chandsharma,3,0.01132,17319,65.35225,26501
1736,chandukotagiri1992,3,0.01132,17322,65.36357,26501
1737,chenmay0921,3,0.01132,17325,65.37489,26501
1738,chenna-017,3,0.01132,17328,65.38621,26501
1739,chenqi0825,3,0.01132,17331,65.39753,26501
1740,Chiefy0x1,3,0.01132,17334,65.40885,26501
1741,chncaption,3,0.01132,17337,65.42017,26501
1742,chomey,3,0.01132,17340,65.43149,26501
1743,chong19951021,3,0.01132,17343,65.44281,26501
1744,chrisaq,3,0.01132,17346,65.45413,26501
1745,ChuckChen123,3,0.01132,17349,65.46545,26501
1746,chuyang-deng,3,0.01132,17352,65.47677,26501
1747,cjabrantes,3,0.01132,17355,65.48809,26501
1748,cjoprey,3,0.01132,17358,65.49942,26501
1749,Cliftonz,3,0.01132,17361,65.51074,26501
1750,cloudties,3,0.01132,17364,65.52206,26501
1751,cngzhnp,3,0.01132,17367,65.53338,26501
1752,colossatr0n,3,0.01132,17370,65.54470,26501
1753,conradj3,3,0.01132,17373,65.55602,26501
1754,cplao,3,0.01132,17376,65.56734,26501
1755,Cr4mble,3,0.01132,17379,65.57866,26501
1756,crengifo,3,0.01132,17382,65.58998,26501
1757,cshah04,3,0.01132,17385,65.60130,26501
1758,cshiv,3,0.01132,17388,65.61262,26501
1759,csrlsm,3,0.01132,17391,65.62394,26501
1760,c-villain,3,0.01132,17394,65.63526,26501
1761,cwangVT,3,0.01132,17397,65.64658,26501
1762,cwjenkins,3,0.01132,17400,65.65790,26501
1763,Dai-Yi,3,0.01132,17403,65.66922,26501
1764,dambott,3,0.01132,17406,65.68054,26501
1765,damianobarbati,3,0.01132,17409,65.69186,26501
1766,DanielMcAssey,3,0.01132,17412,65.70318,26501
1767,darkfeline,3,0.01132,17415,65.71450,26501
1768,darren-mcdonald,3,0.01132,17418,65.72582,26501
1769,datavisorzhizhu,3,0.01132,17421,65.73714,26501
1770,davesee,3,0.01132,17424,65.74846,26501
1771,daviddob,3,0.01132,17427,65.75978,26501
1772,davidLif,3,0.01132,17430,65.77110,26501
1773,denihot,3,0.01132,17433,65.78242,26501
1774,derpsteb,3,0.01132,17436,65.79374,26501
1775,desp0916,3,0.01132,17439,65.80506,26501
1776,Detoxify92,3,0.01132,17442,65.81638,26501
1777,devenderkamble2101,3,0.01132,17445,65.82770,26501
1778,Dev-Hi,3,0.01132,17448,65.83902,26501
1779,DeWaRs1206,3,0.01132,17451,65.85035,26501
1780,dh185221,3,0.01132,17454,65.86167,26501
1781,dhaspden,3,0.01132,17457,65.87299,26501
1782,Dhi13man,3,0.01132,17460,65.88431,26501
1783,diegomezg,3,0.01132,17463,65.89563,26501
1784,dke,3,0.01132,17466,65.90695,26501
1785,dlemfh,3,0.01132,17469,65.91827,26501
1786,dmfigol,3,0.01132,17472,65.92959,26501
1787,dmitryk-dk,3,0.01132,17475,65.94091,26501
1788,dmmishyn,3,0.01132,17478,65.95223,26501
1789,dmvariphy,3,0.01132,17481,65.96355,26501
1790,domokap,3,0.01132,17484,65.97487,26501
1791,doroncarmeli,3,0.01132,17487,65.98619,26501
1792,dpifke,3,0.01132,17490,65.99751,26501
1793,dqzboy,3,0.01132,17493,66.00883,26501
1794,Dreamsorcerer,3,0.01132,17496,66.02015,26501
1795,droger88,3,0.01132,17499,66.03147,26501
1796,drok,3,0.01132,17502,66.04279,26501
1797,drwx,3,0.01132,17505,66.05411,26501
1798,dsanchez31,3,0.01132,17508,66.06543,26501
1799,dweitzman-codaio,3,0.01132,17511,66.07675,26501
1800,dyurchanka,3,0.01132,17514,66.08807,26501
1801,edr3x,3,0.01132,17517,66.09939,26501
1802,e-gloo,3,0.01132,17520,66.11071,26501
1803,ehsan-tashkhisi,3,0.01132,17523,66.12203,26501
1804,eitanby,3,0.01132,17526,66.13335,26501
1805,EladLeev,3,0.01132,17529,66.14467,26501
1806,eleven6,3,0.01132,17532,66.15599,26501
1807,EliasICerezo,3,0.01132,17535,66.16731,26501
1808,eliseuborges,3,0.01132,17538,66.17863,26501
1809,elraoustih,3,0.01132,17541,66.18996,26501
1810,eltonwelsch,3,0.01132,17544,66.20128,26501
1811,emiljanogj,3,0.01132,17547,66.21260,26501
1812,ensono-michaelhogg,3,0.01132,17550,66.22392,26501
1813,eranseer,3,0.01132,17553,66.23524,26501
1814,ericorth,3,0.01132,17556,66.24656,26501
1815,ericvale0128,3,0.01132,17559,66.25788,26501
1816,eslam-gomaa,3,0.01132,17562,66.26920,26501
1817,estherannorzie,3,0.01132,17565,66.28052,26501
1818,etungsten,3,0.01132,17568,66.29184,26501
1819,Eucliddd,3,0.01132,17571,66.30316,26501
1820,eugercek,3,0.01132,17574,66.31448,26501
1821,EvenChang,3,0.01132,17577,66.32580,26501
1822,eyltl,3,0.01132,17580,66.33712,26501
1823,faizahmedfarooqui,3,0.01132,17583,66.34844,26501
1824,federicocodo,3,0.01132,17586,66.35976,26501
1825,ferenc-crey,3,0.01132,17589,66.37108,26501
1826,flat35hd99,3,0.01132,17592,66.38240,26501
1827,flybyray,3,0.01132,17595,66.39372,26501
1828,forgedbrew,3,0.01132,17598,66.40504,26501
1829,fponce66,3,0.01132,17601,66.41636,26501
1830,FrancoR3,3,0.01132,17604,66.42768,26501
1831,frantjc,3,0.01132,17607,66.43900,26501
1832,fred-aa,3,0.01132,17610,66.45032,26501
1833,freddie400,3,0.01132,17613,66.46164,26501
1834,frycm,3,0.01132,17616,66.47296,26501
1835,fusidic,3,0.01132,17619,66.48428,26501
1836,g00ntar,3,0.01132,17622,66.49560,26501
1837,gabriel-farache,3,0.01132,17625,66.50692,26501
1838,gabrielwere,3,0.01132,17628,66.51824,26501
1839,gaochuang,3,0.01132,17631,66.52956,26501
1840,gayatk,3,0.01132,17634,66.54089,26501
1841,gb2111,3,0.01132,17637,66.55221,26501
1842,geekboood,3,0.01132,17640,66.56353,26501
1843,georgethegreatat,3,0.01132,17643,66.57485,26501
1844,gfournierflinks,3,0.01132,17646,66.58617,26501
1845,ghtian123,3,0.01132,17649,66.59749,26501
1846,gifflet,3,0.01132,17652,66.60881,26501
1847,giniman0711,3,0.01132,17655,66.62013,26501
1848,GinjiJizai,3,0.01132,17658,66.63145,26501
1849,gitsan13,3,0.01132,17661,66.64277,26501
1850,gjeltep,3,0.01132,17664,66.65409,26501
1851,glaudiston,3,0.01132,17667,66.66541,26501
1852,gnd,3,0.01132,17670,66.67673,26501
1853,gnuion,3,0.01132,17673,66.68805,26501
1854,golakotigopala,3,0.01132,17676,66.69937,26501
1855,GoldenCorgo,3,0.01132,17679,66.71069,26501
1856,Gonzoe79,3,0.01132,17682,66.72201,26501
1857,Gourav2912,3,0.01132,17685,66.73333,26501
1858,granicayv,3,0.01132,17688,66.74465,26501
1859,gspetrou,3,0.01132,17691,66.75597,26501
1860,gulecroc,3,0.01132,17694,66.76729,26501
1861,gun082544,3,0.01132,17697,66.77861,26501
1862,gunhak01,3,0.01132,17700,66.78993,26501
1863,GuyKomari,3,0.01132,17703,66.80125,26501
1864,gyutaeb,3,0.01132,17706,66.81257,26501
1865,gz243,3,0.01132,17709,66.82389,26501
1866,HailiangChang,3,0.01132,17712,66.83521,26501
1867,hakenr,3,0.01132,17715,66.84653,26501
1868,hamidsafdari,3,0.01132,17718,66.85785,26501
1869,hanem100k,3,0.01132,17721,66.86917,26501
1870,haobin-ihealth,3,0.01132,17724,66.88050,26501
1871,HappyCodingMouse,3,0.01132,17727,66.89182,26501
1872,hargut,3,0.01132,17730,66.90314,26501
1873,HarithaPatchari054,3,0.01132,17733,66.91446,26501
1874,Harsh-U-Joshi,3,0.01132,17736,66.92578,26501
1875,hczv,3,0.01132,17739,66.93710,26501
1876,hecklawert,3,0.01132,17742,66.94842,26501
1877,hehuels,3,0.01132,17745,66.95974,26501
1878,Helinanu,3,0.01132,17748,66.97106,26501
1879,heratech,3,0.01132,17751,66.98238,26501
1880,himanshuDevopsGuy,3,0.01132,17754,66.99370,26501
1881,hirishh,3,0.01132,17757,67.00502,26501
1882,hjampala,3,0.01132,17760,67.01634,26501
1883,hloeung,3,0.01132,17763,67.02766,26501
1884,hmarko,3,0.01132,17766,67.03898,26501
1885,hmizael,3,0.01132,17769,67.05030,26501
1886,hsvt,3,0.01132,17772,67.06162,26501
1887,huangzynn,3,0.01132,17775,67.07294,26501
1888,Hugoch,3,0.01132,17778,67.08426,26501
1889,huiyizzz,3,0.01132,17781,67.09558,26501
1890,humsarika,3,0.01132,17784,67.10690,26501
1891,Iamzoltan1,3,0.01132,17787,67.11822,26501
1892,ian-h-chamberlain,3,0.01132,17790,67.12954,26501
1893,Iceforestik,3,0.01132,17793,67.14086,26501
1894,Igec1,3,0.01132,17796,67.15218,26501
1895,iiiceoo,3,0.01132,17799,67.16350,26501
1896,i-kenta,3,0.01132,17802,67.17482,26501
1897,ingmarfjolla,3,0.01132,17805,67.18614,26501
1898,iNishant,3,0.01132,17808,67.19746,26501
1899,InoryS,3,0.01132,17811,67.20878,26501
1900,irizwaririz,3,0.01132,17814,67.22010,26501
1901,itetradev,3,0.01132,17817,67.23143,26501
1902,Jaapel,3,0.01132,17820,67.24275,26501
1903,jaepetto,3,0.01132,17823,67.25407,26501
1904,Jaeyo,3,0.01132,17826,67.26539,26501
1905,jafnhaar,3,0.01132,17829,67.27671,26501
1906,jalOO7,3,0.01132,17832,67.28803,26501
1907,jameshennessytempus,3,0.01132,17835,67.29935,26501
1908,JamesMarino,3,0.01132,17838,67.31067,26501
1909,jamespgrant3,3,0.01132,17841,67.32199,26501
1910,jamesphlewis,3,0.01132,17844,67.33331,26501
1911,JasonLou99,3,0.01132,17847,67.34463,26501
1912,Javi3y,3,0.01132,17850,67.35595,26501
1913,jaymcguinness,3,0.01132,17853,67.36727,26501
1914,jd-codelink,3,0.01132,17856,67.37859,26501
1915,jdomingo24,3,0.01132,17859,67.38991,26501
1916,JeanEpp,3,0.01132,17862,67.40123,26501
1917,jehutywong,3,0.01132,17865,67.41255,26501
1918,jelemux,3,0.01132,17868,67.42387,26501
1919,jerryc8,3,0.01132,17871,67.43519,26501
1920,jerwen,3,0.01132,17874,67.44651,26501
1921,jgagnon44,3,0.01132,17877,67.45783,26501
1922,jiamin13579,3,0.01132,17880,67.46915,26501
1923,jiayong-zhou,3,0.01132,17883,67.48047,26501
1924,jicahoo,3,0.01132,17886,67.49179,26501
1925,jingjingliu20,3,0.01132,17889,67.50311,26501
1926,jingyuanli001,3,0.01132,17892,67.51443,26501
1927,jirkasilhan,3,0.01132,17895,67.52575,26501
1928,jjjungkim,3,0.01132,17898,67.53707,26501
1929,j-kap-t,3,0.01132,17901,67.54839,26501
1930,jkjetty,3,0.01132,17904,67.55971,26501
1931,JM322,3,0.01132,17907,67.57104,26501
1932,jnac1984,3,0.01132,17910,67.58236,26501
1933,jndeverteuil,3,0.01132,17913,67.59368,26501
1934,JoDongHyuen,3,0.01132,17916,67.60500,26501
1935,Johannes1509,3,0.01132,17919,67.61632,26501
1936,johanoskarsson,3,0.01132,17922,67.62764,26501
1937,JOJO0527,3,0.01132,17925,67.63896,26501
1938,JoniBecker,3,0.01132,17928,67.65028,26501
1939,jordanbean-msft,3,0.01132,17931,67.66160,26501
1940,jorgegonzalez,3,0.01132,17934,67.67292,26501
1941,joshuarmclean,3,0.01132,17937,67.68424,26501
1942,jsproede,3,0.01132,17940,67.69556,26501
1943,jsteinberg-rbi,3,0.01132,17943,67.70688,26501
1944,jxdn,3,0.01132,17946,67.71820,26501
1945,kaiknight,3,0.01132,17949,67.72952,26501
1946,KailashPatilKP,3,0.01132,17952,67.74084,26501
1947,KamiKuroro,3,0.01132,17955,67.75216,26501
1948,kand617,3,0.01132,17958,67.76348,26501
1949,karhow,3,0.01132,17961,67.77480,26501
1950,Karocyt,3,0.01132,17964,67.78612,26501
1951,katyanna,3,0.01132,17967,67.79744,26501
1952,kayneb,3,0.01132,17970,67.80876,26501
1953,kbslvsk,3,0.01132,17973,67.82008,26501
1954,kbsonlong,3,0.01132,17976,67.83140,26501
1955,keithmcneill,3,0.01132,17979,67.84272,26501
1956,keshavbaweja-git,3,0.01132,17982,67.85404,26501
1957,keskival,3,0.01132,17985,67.86536,26501
1958,KevinDiaz1105,3,0.01132,17988,67.87668,26501
1959,khalkie,3,0.01132,17991,67.88800,26501
1960,kingalech,3,0.01132,17994,67.89932,26501
1961,kirbymark,3,0.01132,17997,67.91064,26501
1962,klainte,3,0.01132,18000,67.92197,26501
1963,klatimer,3,0.01132,18003,67.93329,26501
1964,kloseliebej,3,0.01132,18006,67.94461,26501
1965,kochia4,3,0.01132,18009,67.95593,26501
1966,kolomparrudi,3,0.01132,18012,67.96725,26501
1967,krab-skunk,3,0.01132,18015,67.97857,26501
1968,krishnashed,3,0.01132,18018,67.98989,26501
1969,krptg0,3,0.01132,18021,68.00121,26501
1970,krystian1981,3,0.01132,18024,68.01253,26501
1971,kss95,3,0.01132,18027,68.02385,26501
1972,kunTom,3,0.01132,18030,68.03517,26501
1973,kushalhalder,3,0.01132,18033,68.04649,26501
1974,kwmlodozeniec,3,0.01132,18036,68.05781,26501
1975,kyfujisa,3,0.01132,18039,68.06913,26501
1976,kylehz,3,0.01132,18042,68.08045,26501
1977,Lata1980,3,0.01132,18045,68.09177,26501
1978,lau453,3,0.01132,18048,68.10309,26501
1979,laurentdina,3,0.01132,18051,68.11441,26501
1980,lazargugleta,3,0.01132,18054,68.12573,26501
1981,lazy-wangxl,3,0.01132,18057,68.13705,26501
1982,lbrunOVH,3,0.01132,18060,68.14837,26501
1983,Lctrs,3,0.01132,18063,68.15969,26501
1984,Leela-SR,3,0.01132,18066,68.17101,26501
1985,legounix,3,0.01132,18069,68.18233,26501
1986,LelvProgrammer,3,0.01132,18072,68.19365,26501
1987,lemosric,3,0.01132,18075,68.20497,26501
1988,lepsusx,3,0.01132,18078,68.21629,26501
1989,leveryd,3,0.01132,18081,68.22761,26501
1990,Leviathan321,3,0.01132,18084,68.23893,26501
1991,Leweyy,3,0.01132,18087,68.25025,26501
1992,lfurukawa-ml,3,0.01132,18090,68.26158,26501
1993,lieryan,3,0.01132,18093,68.27290,26501
1994,LilMonk,3,0.01132,18096,68.28422,26501
1995,liming92309,3,0.01132,18099,68.29554,26501
1996,linux-bear,3,0.01132,18102,68.30686,26501
1997,Lion2me,3,0.01132,18105,68.31818,26501
1998,liron-telemessage,3,0.01132,18108,68.32950,26501
1999,liuyi0618,3,0.01132,18111,68.34082,26501
2000,liuyix,3,0.01132,18114,68.35214,26501
2001,llabake,3,0.01132,18117,68.36346,26501
2002,lmbss,3,0.01132,18120,68.37478,26501
2003,Lobosque,3,0.01132,18123,68.38610,26501
2004,loganmarchione,3,0.01132,18126,68.39742,26501
2005,lokeshpkumar,3,0.01132,18129,68.40874,26501
2006,long318737396,3,0.01132,18132,68.42006,26501
2007,losingwind,3,0.01132,18135,68.43138,26501
2008,louisonsarlinmagnus,3,0.01132,18138,68.44270,26501
2009,lox139,3,0.01132,18141,68.45402,26501
2010,lspjx,3,0.01132,18144,68.46534,26501
2011,Ltrock,3,0.01132,18147,68.47666,26501
2012,lucahuettner,3,0.01132,18150,68.48798,26501
2013,lukakama,3,0.01132,18153,68.49930,26501
2014,lukas-unity,3,0.01132,18156,68.51062,26501
2015,lusu007,3,0.01132,18159,68.52194,26501
2016,luxliu,3,0.01132,18162,68.53326,26501
2017,m0riiiii,3,0.01132,18165,68.54458,26501
2018,M4C4R,3,0.01132,18168,68.55590,26501
2019,maany,3,0.01132,18171,68.56722,26501
2020,madantnk,3,0.01132,18174,68.57854,26501
2021,maddy020,3,0.01132,18177,68.58986,26501
2022,magiclobster,3,0.01132,18180,68.60118,26501
2023,mahboobalambeg,3,0.01132,18183,68.61251,26501
2024,mahesharimalla,3,0.01132,18186,68.62383,26501
2025,Mahesh-Gunda-Maersk,3,0.01132,18189,68.63515,26501
2026,mahradk,3,0.01132,18192,68.64647,26501
2027,maical-yang,3,0.01132,18195,68.65779,26501
2028,majiwhut,3,0.01132,18198,68.66911,26501
2029,mamazik,3,0.01132,18201,68.68043,26501
2030,manasabsv26,3,0.01132,18204,68.69175,26501
2031,Manikanth-Lilly,3,0.01132,18207,68.70307,26501
2032,manjula-payyavula,3,0.01132,18210,68.71439,26501
2033,Manojkl,3,0.01132,18213,68.72571,26501
2034,manojnc,3,0.01132,18216,68.73703,26501
2035,marc06210,3,0.01132,18219,68.74835,26501
2036,marekk1717,3,0.01132,18222,68.75967,26501
2037,markapruett,3,0.01132,18225,68.77099,26501
2038,markododa,3,0.01132,18228,68.78231,26501
2039,marmionl,3,0.01132,18231,68.79363,26501
2040,Martande8055,3,0.01132,18234,68.80495,26501
2041,martinhitachi,3,0.01132,18237,68.81627,26501
2042,martininnotec,3,0.01132,18240,68.82759,26501
2043,mathiasbockwoldt,3,0.01132,18243,68.83891,26501
2044,matsukaz,3,0.01132,18246,68.85023,26501
2045,matthew-hagemann,3,0.01132,18249,68.86155,26501
2046,maverick-devil,3,0.01132,18252,68.87287,26501
2047,max-arnold,3,0.01132,18255,68.88419,26501
2048,max-bojorquez,3,0.01132,18258,68.89551,26501
2049,mazad01,3,0.01132,18261,68.90683,26501
2050,mc-a,3,0.01132,18264,68.91815,26501
2051,meenajaeiei,3,0.01132,18267,68.92947,26501
2052,mestadler,3,0.01132,18270,68.94079,26501
2053,mgoodwin1989,3,0.01132,18273,68.95212,26501
2054,michaelbor,3,0.01132,18276,68.96344,26501
2055,Michael-Xing,3,0.01132,18279,68.97476,26501
2056,michal-raska,3,0.01132,18282,68.98608,26501
2057,micheljung,3,0.01132,18285,68.99740,26501
2058,mikerains,3,0.01132,18288,69.00872,26501
2059,MikeRohsoft,3,0.01132,18291,69.02004,26501
2060,milanmayr,3,0.01132,18294,69.03136,26501
2061,mila-rodriguez-netapp,3,0.01132,18297,69.04268,26501
2062,minh-oolio,3,0.01132,18300,69.05400,26501
2063,minimalisticMe,3,0.01132,18303,69.06532,26501
2064,miroljub1995,3,0.01132,18306,69.07664,26501
2065,mitchmckenzie,3,0.01132,18309,69.08796,26501
2066,mkcc6,3,0.01132,18312,69.09928,26501
2067,mk-raven,3,0.01132,18315,69.11060,26501
2068,mluker,3,0.01132,18318,69.12192,26501
2069,mmasdoria,3,0.01132,18321,69.13324,26501
2070,MMquant,3,0.01132,18324,69.14456,26501
2071,moatorres,3,0.01132,18327,69.15588,26501
2072,MohnishMishra,3,0.01132,18330,69.16720,26501
2073,mpprasanth,3,0.01132,18333,69.17852,26501
2074,mrfranc,3,0.01132,18336,69.18984,26501
2075,mrintern,3,0.01132,18339,69.20116,26501
2076,mr-miles,3,0.01132,18342,69.21248,26501
2077,Mr-Pearce,3,0.01132,18345,69.22380,26501
2078,Mr-sunrise,3,0.01132,18348,69.23512,26501
2079,mruzicka,3,0.01132,18351,69.24644,26501
2080,msharran,3,0.01132,18354,69.25776,26501
2081,m-standfuss,3,0.01132,18357,69.26908,26501
2082,mstoetzn97,3,0.01132,18360,69.28040,26501
2083,mtrudel,3,0.01132,18363,69.29172,26501
2084,MujanMujan,3,0.01132,18366,69.30305,26501
2085,mychoxin,3,0.01132,18369,69.31437,26501
2086,mycroftcanner,3,0.01132,18372,69.32569,26501
2087,Myeongseok-Kim,3,0.01132,18375,69.33701,26501
2088,myrthebil,3,0.01132,18378,69.34833,26501
2089,myworldofcloud,3,0.01132,18381,69.35965,26501
2090,Naenil,3,0.01132,18384,69.37097,26501
2091,nagesh1977,3,0.01132,18387,69.38229,26501
2092,naohiroo,3,0.01132,18390,69.39361,26501
2093,navidkhalilian,3,0.01132,18393,69.40493,26501
2094,navin-rai,3,0.01132,18396,69.41625,26501
2095,nex1gen,3,0.01132,18399,69.42757,26501
2096,nguemechieu,3,0.01132,18402,69.43889,26501
2097,niceman114,3,0.01132,18405,69.45021,26501
2098,NicolasGoeddel,3,0.01132,18408,69.46153,26501
2099,nikban95,3,0.01132,18411,69.47285,26501
2100,nileshborse92,3,0.01132,18414,69.48417,26501
2101,nitinmalik00,3,0.01132,18417,69.49549,26501
2102,nitishdsharma,3,0.01132,18420,69.50681,26501
2103,Nitishupkr,3,0.01132,18423,69.51813,26501
2104,noaml-rb,3,0.01132,18426,69.52945,26501
2105,noedadon,3,0.01132,18429,69.54077,26501
2106,nserpiot,3,0.01132,18432,69.55209,26501
2107,ntm97,3,0.01132,18435,69.56341,26501
2108,nullecholkj,3,0.01132,18438,69.57473,26501
2109,nurayko,3,0.01132,18441,69.58605,26501
2110,nuttert,3,0.01132,18444,69.59737,26501
2111,nyitonandor,3,0.01132,18447,69.60869,26501
2112,ogremagi4,3,0.01132,18450,69.62001,26501
2113,o-grigorev,3,0.01132,18453,69.63133,26501
2114,okoethibm,3,0.01132,18456,69.64265,26501
2115,oldcc02,3,0.01132,18459,69.65398,26501
2116,Olg-star,3,0.01132,18462,69.66530,26501
2117,olivercp3,3,0.01132,18465,69.67662,26501
2118,Omqarrr,3,0.01132,18468,69.68794,26501
2119,onelucksnake,3,0.01132,18471,69.69926,26501
2120,orle,3,0.01132,18474,69.71058,26501
2121,orz-nil,3,0.01132,18477,69.72190,26501
2122,oteichmann,3,0.01132,18480,69.73322,26501
2123,oussemabhouri,3,0.01132,18483,69.74454,26501
2124,outer199,3,0.01132,18486,69.75586,26501
2125,owem0410,3,0.01132,18489,69.76718,26501
2126,owen-sly,3,0.01132,18492,69.77850,26501
2127,PahaCore,3,0.01132,18495,69.78982,26501
2128,palmheads,3,0.01132,18498,69.80114,26501
2129,Panxuefeng-loongson,3,0.01132,18501,69.81246,26501
2130,paolopiccinini,3,0.01132,18504,69.82378,26501
2131,paperstarr,3,0.01132,18507,69.83510,26501
2132,parogui,3,0.01132,18510,69.84642,26501
2133,PassionateDeveloper86,3,0.01132,18513,69.85774,26501
2134,pavel-romanov8,3,0.01132,18516,69.86906,26501
2135,pbaity,3,0.01132,18519,69.88038,26501
2136,pb-dod,3,0.01132,18522,69.89170,26501
2137,pderrierw,3,0.01132,18525,69.90302,26501
2138,perjahn,3,0.01132,18528,69.91434,26501
2139,peter-glotfelty,3,0.01132,18531,69.92566,26501
2140,pfrcks,3,0.01132,18534,69.93698,26501
2141,phanidevavarapu,3,0.01132,18537,69.94830,26501
2142,PhilipBehrenberg,3,0.01132,18540,69.95962,26501
2143,philipphomberger,3,0.01132,18543,69.97094,26501
2144,phr0zen,3,0.01132,18546,69.98226,26501
2145,pinpox,3,0.01132,18549,69.99359,26501
2146,pjestin-sym,3,0.01132,18552,70.00491,26501
2147,ploszpe,3,0.01132,18555,70.01623,26501
2148,plukanek,3,0.01132,18558,70.02755,26501
2149,pmuniswamy,3,0.01132,18561,70.03887,26501
2150,pnhoang75,3,0.01132,18564,70.05019,26501
2151,PoorlyDefinedBehaviour,3,0.01132,18567,70.06151,26501
2152,ppfearn,3,0.01132,18570,70.07283,26501
2153,prajnutanix,3,0.01132,18573,70.08415,26501
2154,prashansag62,3,0.01132,18576,70.09547,26501
2155,prathish2503,3,0.01132,18579,70.10679,26501
2156,pratiyush05,3,0.01132,18582,70.11811,26501
2157,praveenchoudhari007,3,0.01132,18585,70.12943,26501
2158,PutuPhoton,3,0.01132,18588,70.14075,26501
2159,pvallone,3,0.01132,18591,70.15207,26501
2160,pvreddy37,3,0.01132,18594,70.16339,26501
2161,q7314568,3,0.01132,18597,70.17471,26501
2162,qa-bernhard-schaidhammer,3,0.01132,18600,70.18603,26501
2163,qiaoenxin,3,0.01132,18603,70.19735,26501
2164,qixuan-li1,3,0.01132,18606,70.20867,26501
2165,quintonlucyk,3,0.01132,18609,70.21999,26501
2166,Qyanjia,3,0.01132,18612,70.23131,26501
2167,rahulcadiga,3,0.01132,18615,70.24263,26501
2168,rahul-satal,3,0.01132,18618,70.25395,26501
2169,Rainson12,3,0.01132,18621,70.26527,26501
2170,raja444,3,0.01132,18624,70.27659,26501
2171,Rama-Krishna-P,3,0.01132,18627,70.28791,26501
2172,ramanujd,3,0.01132,18630,70.29923,26501
2173,RamboRogers,3,0.01132,18633,70.31055,26501
2174,rameshmishra593,3,0.01132,18636,70.32187,26501
2175,raosaurabh,3,0.01132,18639,70.33319,26501
2176,rascasoft,3,0.01132,18642,70.34452,26501
2177,rashiq,3,0.01132,18645,70.35584,26501
2178,Raushan-Sapiens,3,0.01132,18648,70.36716,26501
2179,Raven888888,3,0.01132,18651,70.37848,26501
2180,rdoherty-fastly,3,0.01132,18654,70.38980,26501
2181,ReddaHawk,3,0.01132,18657,70.40112,26501
2182,reddaly,3,0.01132,18660,70.41244,26501
2183,relativelyrehan,3,0.01132,18663,70.42376,26501
2184,renatomariscal,3,0.01132,18666,70.43508,26501
2185,rhinck,3,0.01132,18669,70.44640,26501
2186,rhymes,3,0.01132,18672,70.45772,26501
2187,rhysviz,3,0.01132,18675,70.46904,26501
2188,riazantsev,3,0.01132,18678,70.48036,26501
2189,rikycaldeira,3,0.01132,18681,70.49168,26501
2190,rishabhgargg,3,0.01132,18684,70.50300,26501
2191,riteshpayufin,3,0.01132,18687,70.51432,26501
2192,rjdenney,3,0.01132,18690,70.52564,26501
2193,robertchris44,3,0.01132,18693,70.53696,26501
2194,robjcaskey,3,0.01132,18696,70.54828,26501
2195,RogerioWagner,3,0.01132,18699,70.55960,26501
2196,romerobu,3,0.01132,18702,70.57092,26501
2197,ronabet,3,0.01132,18705,70.58224,26501
2198,rong-lei,3,0.01132,18708,70.59356,26501
2199,ronniee007,3,0.01132,18711,70.60488,26501
2200,rootik,3,0.01132,18714,70.61620,26501
2201,rozen-dada,3,0.01132,18717,70.62752,26501
2202,rsclarke,3,0.01132,18720,70.63884,26501
2203,rubulubu,3,0.01132,18723,70.65016,26501
2204,ruieloi,3,0.01132,18726,70.66148,26501
2205,rvarun11,3,0.01132,18729,70.67280,26501
2206,RyanAwareHQ,3,0.01132,18732,70.68413,26501
2207,Rycieos,3,0.01132,18735,70.69545,26501
2208,rydevops,3,0.01132,18738,70.70677,26501
2209,rz-yang,3,0.01132,18741,70.71809,26501
2210,s0uky,3,0.01132,18744,70.72941,26501
2211,sabari-karthik,3,0.01132,18747,70.74073,26501
2212,Sabrina0614,3,0.01132,18750,70.75205,26501
2213,saeedseyfi,3,0.01132,18753,70.76337,26501
2214,Saikatssd,3,0.01132,18756,70.77469,26501
2215,sakorkko,3,0.01132,18759,70.78601,26501
2216,sakryt,3,0.01132,18762,70.79733,26501
2217,SakshiT25,3,0.01132,18765,70.80865,26501
2218,samchenws,3,0.01132,18768,70.81997,26501
2219,samuelkerchouni,3,0.01132,18771,70.83129,26501
2220,samuelluohaoen1,3,0.01132,18774,70.84261,26501
2221,samyabrata-maji,3,0.01132,18777,70.85393,26501
2222,sandijs-private,3,0.01132,18780,70.86525,26501
2223,sankalp28,3,0.01132,18783,70.87657,26501
2224,Sanket1308,3,0.01132,18786,70.88789,26501
2225,sankethb27,3,0.01132,18789,70.89921,26501
2226,satish-suradkar,3,0.01132,18792,70.91053,26501
2227,Satyambhatt1991,3,0.01132,18795,70.92185,26501
2228,sc0ttdav3y,3,0.01132,18798,70.93317,26501
2229,schandrasekaran-mdsol,3,0.01132,18801,70.94449,26501
2230,schneiderlin,3,0.01132,18804,70.95581,26501
2231,scho-to,3,0.01132,18807,70.96713,26501
2232,schucly,3,0.01132,18810,70.97845,26501
2233,scoomthesnooper,3,0.01132,18813,70.98977,26501
2234,scuffe82,3,0.01132,18816,71.00109,26501
2235,SebScoFr,3,0.01132,18819,71.01241,26501
2236,SedemQuame,3,0.01132,18822,71.02373,26501
2237,senthilkumaravelu,3,0.01132,18825,71.03506,26501
2238,SergioTijerino,3,0.01132,18828,71.04638,26501
2239,sethjback,3,0.01132,18831,71.05770,26501
2240,sfwester,3,0.01132,18834,71.06902,26501
2241,shabbiervempalli-yti,3,0.01132,18837,71.08034,26501
2242,shakunt1202,3,0.01132,18840,71.09166,26501
2243,Shambuwu,3,0.01132,18843,71.10298,26501
2244,ShawnJop,3,0.01132,18846,71.11430,26501
2245,shivabohemian,3,0.01132,18849,71.12562,26501
2246,shun095,3,0.01132,18852,71.13694,26501
2247,siiimooon,3,0.01132,18855,71.14826,26501
2248,silviu-dobrica,3,0.01132,18858,71.15958,26501
2249,similark,3,0.01132,18861,71.17090,26501
2250,sivakumark88,3,0.01132,18864,71.18222,26501
2251,sjguro,3,0.01132,18867,71.19354,26501
2252,skeithyoung,3,0.01132,18870,71.20486,26501
2253,skodamarthi,3,0.01132,18873,71.21618,26501
2254,smartfin,3,0.01132,18876,71.22750,26501
2255,smilu97,3,0.01132,18879,71.23882,26501
2256,smriti0710,3,0.01132,18882,71.25014,26501
2257,songchaoqiang,3,0.01132,18885,71.26146,26501
2258,songqing,3,0.01132,18888,71.27278,26501
2259,soobinrho,3,0.01132,18891,71.28410,26501
2260,SoucianceEqdamRashti,3,0.01132,18894,71.29542,26501
2261,sourabh1007,3,0.01132,18897,71.30674,26501
2262,spartan289,3,0.01132,18900,71.31806,26501
2263,srclark213,3,0.01132,18903,71.32938,26501
2264,sreejithtessell,3,0.01132,18906,71.34070,26501
2265,srikanthpacco,3,0.01132,18909,71.35202,26501
2266,srimaln91,3,0.01132,18912,71.36334,26501
2267,sriraamas,3,0.01132,18915,71.37467,26501
2268,staleks,3,0.01132,18918,71.38599,26501
2269,stas-neverov,3,0.01132,18921,71.39731,26501
2270,stasos24,3,0.01132,18924,71.40863,26501
2271,stepaniukm,3,0.01132,18927,71.41995,26501
2272,steromano87,3,0.01132,18930,71.43127,26501
2273,stevenharman,3,0.01132,18933,71.44259,26501
2274,StuartCrichton,3,0.01132,18936,71.45391,26501
2275,sujeet01,3,0.01132,18939,71.46523,26501
2276,sumithreddy,3,0.01132,18942,71.47655,26501
2277,sumiti12,3,0.01132,18945,71.48787,26501
2278,suxi,3,0.01132,18948,71.49919,26501
2279,sw1136562366,3,0.01132,18951,71.51051,26501
2280,swagftw,3,0.01132,18954,71.52183,26501
2281,Swarno-Coder,3,0.01132,18957,71.53315,26501
2282,swerdick,3,0.01132,18960,71.54447,26501
2283,swhite24,3,0.01132,18963,71.55579,26501
2284,t0d0r,3,0.01132,18966,71.56711,26501
2285,tahacanatak,3,0.01132,18969,71.57843,26501
2286,Tal-Hason,3,0.01132,18972,71.58975,26501
2287,TamasBarta,3,0.01132,18975,71.60107,26501
2288,TarasZubreiFiverr,3,0.01132,18978,71.61239,26501
2289,tarmo-profi,3,0.01132,18981,71.62371,26501
2290,tarrow,3,0.01132,18984,71.63503,26501
2291,tashoyan,3,0.01132,18987,71.64635,26501
2292,taz77,3,0.01132,18990,71.65767,26501
2293,tcinbis,3,0.01132,18993,71.66899,26501
2294,TerrorJack,3,0.01132,18996,71.68031,26501
2295,TeslaCN,3,0.01132,18999,71.69163,26501
2296,Tette69,3,0.01132,19002,71.70295,26501
2297,TheCakeMonster,3,0.01132,19005,71.71427,26501
2298,thejohnrichard,3,0.01132,19008,71.72560,26501
2299,themkarimi,3,0.01132,19011,71.73692,26501
2300,theoilie,3,0.01132,19014,71.74824,26501
2301,TheReal1604,3,0.01132,19017,71.75956,26501
2302,timbussmann,3,0.01132,19020,71.77088,26501
2303,tim-chaplin-dd,3,0.01132,19023,71.78220,26501
2304,timur-enikeev,3,0.01132,19026,71.79352,26501
2305,tituschu0628,3,0.01132,19029,71.80484,26501
2306,T-M-A,3,0.01132,19032,71.81616,26501
2307,togie6,3,0.01132,19035,71.82748,26501
2308,tomiaa1926,3,0.01132,19038,71.83880,26501
2309,TonyFjo,3,0.01132,19041,71.85012,26501
2310,toralf-hlag,3,0.01132,19044,71.86144,26501
2311,tr3mor,3,0.01132,19047,71.87276,26501
2312,trevor-carlson1,3,0.01132,19050,71.88408,26501
2313,triangularcover,3,0.01132,19053,71.89540,26501
2314,TrojIhor,3,0.01132,19056,71.90672,26501
2315,ttarando,3,0.01132,19059,71.91804,26501
2316,turbo1912,3,0.01132,19062,71.92936,26501
2317,turbodeploy,3,0.01132,19065,71.94068,26501
2318,twunderlich-grapl,3,0.01132,19068,71.95200,26501
2319,Tylermarques,3,0.01132,19071,71.96332,26501
2320,ucguy4u,3,0.01132,19074,71.97464,26501
2321,ucsky,3,0.01132,19077,71.98596,26501
2322,ur4t,3,0.01132,19080,71.99728,26501
2323,UramnOIL,3,0.01132,19083,72.00860,26501
2324,ustc-wxy,3,0.01132,19086,72.01992,26501
2325,uzador,3,0.01132,19089,72.03124,26501
2326,vadiml77,3,0.01132,19092,72.04256,26501
2327,Vaibhavi-Tanla,3,0.01132,19095,72.05388,26501
2328,vardhaman22,3,0.01132,19098,72.06521,26501
2329,vb3328998,3,0.01132,19101,72.07653,26501
2330,vbrunko-voc,3,0.01132,19104,72.08785,26501
2331,Velan987,3,0.01132,19107,72.09917,26501
2332,verejoel,3,0.01132,19110,72.11049,26501
2333,vexingly,3,0.01132,19113,72.12181,26501
2334,victoryang00,3,0.01132,19116,72.13313,26501
2335,vinkiel,3,0.01132,19119,72.14445,26501
2336,virtualluke,3,0.01132,19122,72.15577,26501
2337,VishakArudhra,3,0.01132,19125,72.16709,26501
2338,VishalDamgude,3,0.01132,19128,72.17841,26501
2339,vivekdasarieric,3,0.01132,19131,72.18973,26501
2340,vivekyad4v,3,0.01132,19134,72.20105,26501
2341,VoxT,3,0.01132,19137,72.21237,26501
2342,vuonghung12,3,0.01132,19140,72.22369,26501
2343,walsm232,3,0.01132,19143,72.23501,26501
2344,walterj028,3,0.01132,19146,72.24633,26501
2345,waxyxkoelman,3,0.01132,19149,72.25765,26501
2346,WBrettDavis,3,0.01132,19152,72.26897,26501
2347,wcpsoft,3,0.01132,19155,72.28029,26501
2348,weapons97,3,0.01132,19158,72.29161,26501
2349,WesselAtWork,3,0.01132,19161,72.30293,26501
2350,weyus,3,0.01132,19164,72.31425,26501
2351,willia83,3,0.01132,19167,72.32557,26501
2352,Williamredondo,3,0.01132,19170,72.33689,26501
2353,wilsondlli,3,0.01132,19173,72.34821,26501
2354,wimmerX,3,0.01132,19176,72.35953,26501
2355,winary,3,0.01132,19179,72.37085,26501
2356,wl-chen,3,0.01132,19182,72.38217,26501
2357,Wonong,3,0.01132,19185,72.39349,26501
2358,wuxs,3,0.01132,19188,72.40481,26501
2359,WVenus,3,0.01132,19191,72.41614,26501
2360,wywanlv,3,0.01132,19194,72.42746,26501
2361,xahon,3,0.01132,19197,72.43878,26501
2362,xiaozjw123,3,0.01132,19200,72.45010,26501
2363,xodiumluma,3,0.01132,19203,72.46142,26501
2364,xu1257,3,0.01132,19206,72.47274,26501
2365,xuyang3232,3,0.01132,19209,72.48406,26501
2366,xw-patrick,3,0.01132,19212,72.49538,26501
2367,xwz-ol,3,0.01132,19215,72.50670,26501
2368,yahiya-ayoub,3,0.01132,19218,72.51802,26501
2369,yanbuduo,3,0.01132,19221,72.52934,26501
2370,Yanhan0507,3,0.01132,19224,72.54066,26501
2371,yanhao-pro,3,0.01132,19227,72.55198,26501
2372,YasiruShaminda,3,0.01132,19230,72.56330,26501
2373,y-okamoto-1113,3,0.01132,19233,72.57462,26501
2374,yoonseokho,3,0.01132,19236,72.58594,26501
2375,yotama-anv,3,0.01132,19239,72.59726,26501
2376,yuliya-salesforce,3,0.01132,19242,72.60858,26501
2377,zach-mitchell-rtx,3,0.01132,19245,72.61990,26501
2378,Zaporozhec7,3,0.01132,19248,72.63122,26501
2379,zaq-at-varian,3,0.01132,19251,72.64254,26501
2380,zenitraM,3,0.01132,19254,72.65386,26501
2381,ZenoRewn,3,0.01132,19257,72.66518,26501
2382,zenpk,3,0.01132,19260,72.67650,26501
2383,zerb4t,3,0.01132,19263,72.68782,26501
2384,zhengxingjian,3,0.01132,19266,72.69914,26501
2385,zhgit35,3,0.01132,19269,72.71046,26501
2386,zhiyangwang96,3,0.01132,19272,72.72178,26501
2387,zhuoyuan-liu,3,0.01132,19275,72.73310,26501
2388,zizhong,3,0.01132,19278,72.74442,26501
2389,zraining,3,0.01132,19281,72.75575,26501
2390,zshmmm,3,0.01132,19284,72.76707,26501
2391,0LuckyLove0,2,0.00755,19286,72.77461,26501
2392,0Styless,2,0.00755,19288,72.78216,26501
2393,0xAlcibiades,2,0.00755,19290,72.78971,26501
2394,10935336,2,0.00755,19292,72.79725,26501
2395,1486756632,2,0.00755,19294,72.80480,26501
2396,22f-cy,2,0.00755,19296,72.81235,26501
2397,43754,2,0.00755,19298,72.81989,26501
2398,4change,2,0.00755,19300,72.82744,26501
2399,4everming,2,0.00755,19302,72.83499,26501
2400,601579263,2,0.00755,19304,72.84253,26501
2401,94rain,2,0.00755,19306,72.85008,26501
2402,963230432,2,0.00755,19308,72.85763,26501
2403,aakharbotli,2,0.00755,19310,72.86517,26501
2404,Abdur-rahmaanJ,2,0.00755,19312,72.87272,26501
2405,abhayakyy,2,0.00755,19314,72.88027,26501
2406,Abhilash-as,2,0.00755,19316,72.88782,26501
2407,abhoffmann,2,0.00755,19318,72.89536,26501
2408,abkura,2,0.00755,19320,72.90291,26501
2409,acshekhara1,2,0.00755,19322,72.91046,26501
2410,adarshk-rapido,2,0.00755,19324,72.91800,26501
2411,Adarsh-kumar,2,0.00755,19326,72.92555,26501
2412,adarsh-padhi,2,0.00755,19328,72.93310,26501
2413,aditi9991,2,0.00755,19330,72.94064,26501
2414,Aditya-150,2,0.00755,19332,72.94819,26501
2415,AdmiralNemo,2,0.00755,19334,72.95574,26501
2416,adrianiacobghiula,2,0.00755,19336,72.96328,26501
2417,aebrahim,2,0.00755,19338,72.97083,26501
2418,aeidt4,2,0.00755,19340,72.97838,26501
2419,afgane,2,0.00755,19342,72.98593,26501
2420,agni3921,2,0.00755,19344,72.99347,26501
2421,AgSync-Aaron,2,0.00755,19346,73.00102,26501
2422,Ahmad-RW,2,0.00755,19348,73.00857,26501
2423,ahsanashraf918,2,0.00755,19350,73.01611,26501
2424,aibor,2,0.00755,19352,73.02366,26501
2425,ajaypalRumtra,2,0.00755,19354,73.03121,26501
2426,ajiteb,2,0.00755,19356,73.03875,26501
2427,akashhr-intel,2,0.00755,19358,73.04630,26501
2428,aka-switch,2,0.00755,19360,73.05385,26501
2429,akose73,2,0.00755,19362,73.06139,26501
2430,akramIOT,2,0.00755,19364,73.06894,26501
2431,AlamBeg,2,0.00755,19366,73.07649,26501
2432,alanraison,2,0.00755,19368,73.08403,26501
2433,alawrenc,2,0.00755,19370,73.09158,26501
2434,AldoCF96,2,0.00755,19372,73.09913,26501
2435,alecss131,2,0.00755,19374,73.10668,26501
2436,alegalwx,2,0.00755,19376,73.11422,26501
2437,alekseevx,2,0.00755,19378,73.12177,26501
2438,alelthomas,2,0.00755,19380,73.12932,26501
2439,alex5517,2,0.00755,19382,73.13686,26501
2440,AlexanderArgyriou,2,0.00755,19384,73.14441,26501
2441,alexei-bykovski,2,0.00755,19386,73.15196,26501
2442,alexeych0,2,0.00755,19388,73.15950,26501
2443,AlexHill,2,0.00755,19390,73.16705,26501
2444,alexisstgc,2,0.00755,19392,73.17460,26501
2445,alexistimic,2,0.00755,19394,73.18214,26501
2446,alexjia823,2,0.00755,19396,73.18969,26501
2447,AlexLi88,2,0.00755,19398,73.19724,26501
2448,alexwhiteoval,2,0.00755,19400,73.20478,26501
2449,AlexXin14,2,0.00755,19402,73.21233,26501
2450,Alfredo-Moreira,2,0.00755,19404,73.21988,26501
2451,algor1th,2,0.00755,19406,73.22743,26501
2452,alhucave,2,0.00755,19408,73.23497,26501
2453,Alig1493,2,0.00755,19410,73.24252,26501
2454,alimac87,2,0.00755,19412,73.25007,26501
2455,AllaouaA,2,0.00755,19414,73.25761,26501
2456,Alonso289,2,0.00755,19416,73.26516,26501
2457,alphanoob1337,2,0.00755,19418,73.27271,26501
2458,Altair-Bueno,2,0.00755,19420,73.28025,26501
2459,altro3,2,0.00755,19422,73.28780,26501
2460,alvarogomez93,2,0.00755,19424,73.29535,26501
2461,alxivanov,2,0.00755,19426,73.30289,26501
2462,amal-krm,2,0.00755,19428,73.31044,26501
2463,Aman-g99,2,0.00755,19430,73.31799,26501
2464,amitjain3087,2,0.00755,19432,73.32553,26501
2465,amit-kumar59,2,0.00755,19434,73.33308,26501
2466,amng,2,0.00755,19436,73.34063,26501
2467,amolgautam25,2,0.00755,19438,73.34818,26501
2468,Amornrit44,2,0.00755,19440,73.35572,26501
2469,Ampler92,2,0.00755,19442,73.36327,26501
2470,Ampsyy,2,0.00755,19444,73.37082,26501
2471,anandf,2,0.00755,19446,73.37836,26501
2472,anandraiin3,2,0.00755,19448,73.38591,26501
2473,AnatoliiNefedov,2,0.00755,19450,73.39346,26501
2474,anderssonw,2,0.00755,19452,73.40100,26501
2475,andreimladin,2,0.00755,19454,73.40855,26501
2476,andrewcameronsims,2,0.00755,19456,73.41610,26501
2477,andrewdinunzio,2,0.00755,19458,73.42364,26501
2478,andrew-welker,2,0.00755,19460,73.43119,26501
2479,andreyreshetnikov-zh,2,0.00755,19462,73.43874,26501
2480,andriymahats,2,0.00755,19464,73.44629,26501
2481,AndyHutchND,2,0.00755,19466,73.45383,26501
2482,anh-oolio,2,0.00755,19468,73.46138,26501
2483,AnishMadan,2,0.00755,19470,73.46893,26501
2484,Ankcorn,2,0.00755,19472,73.47647,26501
2485,Ankit098,2,0.00755,19474,73.48402,26501
2486,anthonyjacques20,2,0.00755,19476,73.49157,26501
2487,AntonioFalcaoJr,2,0.00755,19478,73.49911,26501
2488,antstacks,2,0.00755,19480,73.50666,26501
2489,anujgupta09,2,0.00755,19482,73.51421,26501
2490,apatotski,2,0.00755,19484,73.52175,26501
2491,a-pedroso,2,0.00755,19486,73.52930,26501
2492,apratinav-intuit,2,0.00755,19488,73.53685,26501
2493,argarinpauljohn,2,0.00755,19490,73.54439,26501
2494,ariretiarno,2,0.00755,19492,73.55194,26501
2495,arjundevarajan,2,0.00755,19494,73.55949,26501
2496,arjungopisetty,2,0.00755,19496,73.56704,26501
2497,arjunsingriuber,2,0.00755,19498,73.57458,26501
2498,arloor,2,0.00755,19500,73.58213,26501
2499,arunbtech24,2,0.00755,19502,73.58968,26501
2500,aryabyte21,2,0.00755,19504,73.59722,26501
2501,aryans1319,2,0.00755,19506,73.60477,26501
2502,ashish2014,2,0.00755,19508,73.61232,26501
2503,ashishm19990,2,0.00755,19510,73.61986,26501
2504,ashwhall,2,0.00755,19512,73.62741,26501
2505,ashwin0630,2,0.00755,19514,73.63496,26501
2506,asitkumar13,2,0.00755,19516,73.64250,26501
2507,Asmokin11,2,0.00755,19518,73.65005,26501
2508,asood-rh,2,0.00755,19520,73.65760,26501
2509,astephanh,2,0.00755,19522,73.66514,26501
2510,asthamohta,2,0.00755,19524,73.67269,26501
2511,astingengo,2,0.00755,19526,73.68024,26501
2512,atiwaripw,2,0.00755,19528,73.68779,26501
2513,AtomicJon,2,0.00755,19530,73.69533,26501
2514,auxsvr,2,0.00755,19532,73.70288,26501
2515,avimalakar,2,0.00755,19534,73.71043,26501
2516,aweeraman,2,0.00755,19536,73.71797,26501
2517,awilson-payit,2,0.00755,19538,73.72552,26501
2518,AYANGt,2,0.00755,19540,73.73307,26501
2519,ayesha54,2,0.00755,19542,73.74061,26501
2520,aymond,2,0.00755,19544,73.74816,26501
2521,ayush14rastogi,2,0.00755,19546,73.75571,26501
2522,ayushontop,2,0.00755,19548,73.76325,26501
2523,ayush-rathore-robomq,2,0.00755,19550,73.77080,26501
2524,A-Zhai123,2,0.00755,19552,73.77835,26501
2525,azxs6400949,2,0.00755,19554,73.78589,26501
2526,b3n3w,2,0.00755,19556,73.79344,26501
2527,bagweraj,2,0.00755,19558,73.80099,26501
2528,bakape,2,0.00755,19560,73.80854,26501
2529,Ballhausen,2,0.00755,19562,73.81608,26501
2530,baoqiangliu,2,0.00755,19564,73.82363,26501
2531,baosiling,2,0.00755,19566,73.83118,26501
2532,bastantoine,2,0.00755,19568,73.83872,26501
2533,batman1754,2,0.00755,19570,73.84627,26501
2534,batunpc,2,0.00755,19572,73.85382,26501
2535,bbeuning,2,0.00755,19574,73.86136,26501
2536,bclewis1,2,0.00755,19576,73.86891,26501
2537,belgaied2,2,0.00755,19578,73.87646,26501
2538,benhosmereop,2,0.00755,19580,73.88400,26501
2539,benpro,2,0.00755,19582,73.89155,26501
2540,benson211,2,0.00755,19584,73.89910,26501
2541,BenWa67,2,0.00755,19586,73.90665,26501
2542,benyko,2,0.00755,19588,73.91419,26501
2543,bernardoforcillo,2,0.00755,19590,73.92174,26501
2544,Berrysoft,2,0.00755,19592,73.92929,26501
2545,betabrandao,2,0.00755,19594,73.93683,26501
2546,Bexanderthebex,2,0.00755,19596,73.94438,26501
2547,bgdnxt,2,0.00755,19598,73.95193,26501
2548,bgranier,2,0.00755,19600,73.95947,26501
2549,BhagyaAmarasinghe,2,0.00755,19602,73.96702,26501
2550,Bhargavram3468,2,0.00755,19604,73.97457,26501
2551,bhaumikmithun,2,0.00755,19606,73.98211,26501
2552,bhavinkotak,2,0.00755,19608,73.98966,26501
2553,bhubert,2,0.00755,19610,73.99721,26501
2554,Bigguy34,2,0.00755,19612,74.00475,26501
2555,binhoul,2,0.00755,19614,74.01230,26501
2556,bjor-joh,2,0.00755,19616,74.01985,26501
2557,blanche789,2,0.00755,19618,74.02740,26501
2558,blars,2,0.00755,19620,74.03494,26501
2559,blauzattoo,2,0.00755,19622,74.04249,26501
2560,blocklaker,2,0.00755,19624,74.05004,26501
2561,bobbyz007,2,0.00755,19626,74.05758,26501
2562,bonzo71,2,0.00755,19628,74.06513,26501
2563,boreq,2,0.00755,19630,74.07268,26501
2564,boroskoyo,2,0.00755,19632,74.08022,26501
2565,bossan,2,0.00755,19634,74.08777,26501
2566,bq-arpit-20,2,0.00755,19636,74.09532,26501
2567,brandonguigo,2,0.00755,19638,74.10286,26501
2568,brandonphan,2,0.00755,19640,74.11041,26501
2569,brekke-roq,2,0.00755,19642,74.11796,26501
2570,brianwang12,2,0.00755,19644,74.12550,26501
2571,brunobastosg,2,0.00755,19646,74.13305,26501
2572,bryanchriswhite,2,0.00755,19648,74.14060,26501
2573,bryan-cox,2,0.00755,19650,74.14815,26501
2574,btbouwens,2,0.00755,19652,74.15569,26501
2575,btprocorp,2,0.00755,19654,74.16324,26501
2576,burmudar,2,0.00755,19656,74.17079,26501
2577,busches,2,0.00755,19658,74.17833,26501
2578,butterunderflow,2,0.00755,19660,74.18588,26501
2579,bxtp4p,2,0.00755,19662,74.19343,26501
2580,byjupm,2,0.00755,19664,74.20097,26501
2581,caiwh,2,0.00755,19666,74.20852,26501
2582,calogxro,2,0.00755,19668,74.21607,26501
2583,candrews,2,0.00755,19670,74.22361,26501
2584,carolinacass,2,0.00755,19672,74.23116,26501
2585,cataggar,2,0.00755,19674,74.23871,26501
2586,cchawn,2,0.00755,19676,74.24625,26501
2587,ccorbacho,2,0.00755,19678,74.25380,26501
2588,cdash415,2,0.00755,19680,74.26135,26501
2589,cdjianghan,2,0.00755,19682,74.26890,26501
2590,CenkuSands,2,0.00755,19684,74.27644,26501
2591,cescgina,2,0.00755,19686,74.28399,26501
2592,cgrs,2,0.00755,19688,74.29154,26501
2593,ch1seL,2,0.00755,19690,74.29908,26501
2594,chahatd,2,0.00755,19692,74.30663,26501
2595,chamini2,2,0.00755,19694,74.31418,26501
2596,chancefeick,2,0.00755,19696,74.32172,26501
2597,chandanghoshsfos,2,0.00755,19698,74.32927,26501
2598,charlessensibill,2,0.00755,19700,74.33682,26501
2599,chaychoong,2,0.00755,19702,74.34436,26501
2600,chenchengfa93,2,0.00755,19704,74.35191,26501
2601,chentiangang,2,0.00755,19706,74.35946,26501
2602,ChenX1993,2,0.00755,19708,74.36701,26501
2603,cherishman2005,2,0.00755,19710,74.37455,26501
2604,ChiaSang,2,0.00755,19712,74.38210,26501
2605,chinmaychahar,2,0.00755,19714,74.38965,26501
2606,Choobz,2,0.00755,19716,74.39719,26501
2607,chris62837,2,0.00755,19718,74.40474,26501
2608,chrislin22,2,0.00755,19720,74.41229,26501
2609,christiancostap,2,0.00755,19722,74.41983,26501
2610,ChrisV78,2,0.00755,19724,74.42738,26501
2611,chronicc,2,0.00755,19726,74.43493,26501
2612,CJNA,2,0.00755,19728,74.44247,26501
2613,cjrh,2,0.00755,19730,74.45002,26501
2614,clairelcasey,2,0.00755,19732,74.45757,26501
2615,clesleycode,2,0.00755,19734,74.46511,26501
2616,clodo,2,0.00755,19736,74.47266,26501
2617,cloudinwinter,2,0.00755,19738,74.48021,26501
2618,cmaahs,2,0.00755,19740,74.48776,26501
2619,cmorinupgrade,2,0.00755,19742,74.49530,26501
2620,Codecaver,2,0.00755,19744,74.50285,26501
2621,Coderayush13,2,0.00755,19746,74.51040,26501
2622,codingbycoding,2,0.00755,19748,74.51794,26501
2623,coffee-core,2,0.00755,19750,74.52549,26501
2624,coleary-hyperscience,2,0.00755,19752,74.53304,26501
2625,companionkube,2,0.00755,19754,74.54058,26501
2626,comsma,2,0.00755,19756,74.54813,26501
2627,congguosn,2,0.00755,19758,74.55568,26501
2628,connorsoohoo1,2,0.00755,19760,74.56322,26501
2629,corasaniti,2,0.00755,19762,74.57077,26501
2630,coreylarew,2,0.00755,19764,74.57832,26501
2631,coy18,2,0.00755,19766,74.58586,26501
2632,CracKOl,2,0.00755,19768,74.59341,26501
2633,CristianBB,2,0.00755,19770,74.60096,26501
2634,C-Romeo,2,0.00755,19772,74.60851,26501
2635,crozwise,2,0.00755,19774,74.61605,26501
2636,crsdvaibhav,2,0.00755,19776,74.62360,26501
2637,cschieb,2,0.00755,19778,74.63115,26501
2638,csouza-harness,2,0.00755,19780,74.63869,26501
2639,CSWYF3634076,2,0.00755,19782,74.64624,26501
2640,ctlewis,2,0.00755,19784,74.65379,26501
2641,cwitthaus,2,0.00755,19786,74.66133,26501
2642,cyvcloud,2,0.00755,19788,74.66888,26501
2643,CzapBran,2,0.00755,19790,74.67643,26501
2644,daande,2,0.00755,19792,74.68397,26501
2645,daddyauden,2,0.00755,19794,74.69152,26501
2646,DaeyangCho,2,0.00755,19796,74.69907,26501
2647,daluu,2,0.00755,19798,74.70661,26501
2648,danatcofo,2,0.00755,19800,74.71416,26501
2649,danbugs,2,0.00755,19802,74.72171,26501
2650,daniel-fazeres,2,0.00755,19804,74.72926,26501
2651,danielloader,2,0.00755,19806,74.73680,26501
2652,danielmmetz,2,0.00755,19808,74.74435,26501
2653,danish-rku,2,0.00755,19810,74.75190,26501
2654,Danissss,2,0.00755,19812,74.75944,26501
2655,danliznh,2,0.00755,19814,74.76699,26501
2656,danmihai1,2,0.00755,19816,74.77454,26501
2657,dannyt-cx,2,0.00755,19818,74.78208,26501
2658,dansd,2,0.00755,19820,74.78963,26501
2659,dantanqikun,2,0.00755,19822,74.79718,26501
2660,daocr,2,0.00755,19824,74.80472,26501
2661,darkmatter18,2,0.00755,19826,74.81227,26501
2662,da-sha,2,0.00755,19828,74.81982,26501
2663,data-race,2,0.00755,19830,74.82737,26501
2664,davidggz,2,0.00755,19832,74.83491,26501
2665,davidlublink,2,0.00755,19834,74.84246,26501
2666,DavidR91,2,0.00755,19836,74.85001,26501
2667,davidst2017,2,0.00755,19838,74.85755,26501
2668,david-thrower,2,0.00755,19840,74.86510,26501
2669,dberardo,2,0.00755,19842,74.87265,26501
2670,dbermuehler,2,0.00755,19844,74.88019,26501
2671,dbhuvanapalli,2,0.00755,19846,74.88774,26501
2672,ddalton,2,0.00755,19848,74.89529,26501
2673,deadpyxel,2,0.00755,19850,74.90283,26501
2674,decodingahmed,2,0.00755,19852,74.91038,26501
2675,deepeshaburse,2,0.00755,19854,74.91793,26501
2676,derek-ho,2,0.00755,19856,74.92547,26501
2677,DerGut,2,0.00755,19858,74.93302,26501
2678,derlin,2,0.00755,19860,74.94057,26501
2679,devhg,2,0.00755,19862,74.94812,26501
2680,devilkiller-ag,2,0.00755,19864,74.95566,26501
2681,dgouju,2,0.00755,19866,74.96321,26501
2682,dgraham,2,0.00755,19868,74.97076,26501
2683,dgrittma,2,0.00755,19870,74.97830,26501
2684,d-gucci,2,0.00755,19872,74.98585,26501
2685,dharesign,2,0.00755,19874,74.99340,26501
2686,DharmaWarrior,2,0.00755,19876,75.00094,26501
2687,dhaven,2,0.00755,19878,75.00849,26501
2688,Dietatko,2,0.00755,19880,75.01604,26501
2689,Digtiq,2,0.00755,19882,75.02358,26501
2690,djcrabhat,2,0.00755,19884,75.03113,26501
2691,djkashtan,2,0.00755,19886,75.03868,26501
2692,djocraveiro,2,0.00755,19888,75.04622,26501
2693,dkv,2,0.00755,19890,75.05377,26501
2694,dlescos,2,0.00755,19892,75.06132,26501
2695,Dmaddu,2,0.00755,19894,75.06887,26501
2696,dmitriyilin,2,0.00755,19896,75.07641,26501
2697,doemEINS,2,0.00755,19898,75.08396,26501
2698,dofmind,2,0.00755,19900,75.09151,26501
2699,DogeFlow,2,0.00755,19902,75.09905,26501
2700,Dontcampy,2,0.00755,19904,75.10660,26501
2701,dops-at,2,0.00755,19906,75.11415,26501
2702,dorbae,2,0.00755,19908,75.12169,26501
2703,dougsong,2,0.00755,19910,75.12924,26501
2704,dpearceMN,2,0.00755,19912,75.13679,26501
2705,Dragonsong3k,2,0.00755,19914,75.14433,26501
2706,dseralathan,2,0.00755,19916,75.15188,26501
2707,dswtpvtltd,2,0.00755,19918,75.15943,26501
2708,duddu,2,0.00755,19920,75.16697,26501
2709,dulao5,2,0.00755,19922,75.17452,26501
2710,dungnguyen1254,2,0.00755,19924,75.18207,26501
2711,dupetr,2,0.00755,19926,75.18962,26501
2712,Dusty-Meg,2,0.00755,19928,75.19716,26501
2713,dvdlevanon,2,0.00755,19930,75.20471,26501
2714,dvorst,2,0.00755,19932,75.21226,26501
2715,dwilliss,2,0.00755,19934,75.21980,26501
2716,dwipeshmishra,2,0.00755,19936,75.22735,26501
2717,dyexlzc,2,0.00755,19938,75.23490,26501
2718,ebiiim,2,0.00755,19940,75.24244,26501
2719,ecoupal-believe,2,0.00755,19942,75.24999,26501
2720,Edition-X,2,0.00755,19944,75.25754,26501
2721,edvard-bjarnason,2,0.00755,19946,75.26508,26501
2722,ee07dazn,2,0.00755,19948,75.27263,26501
2723,egevorkyan,2,0.00755,19950,75.28018,26501
2724,ehsanonline,2,0.00755,19952,75.28772,26501
2725,ekinolik,2,0.00755,19954,75.29527,26501
2726,Eliav2,2,0.00755,19956,75.30282,26501
2727,elyasADK,2,0.00755,19958,75.31037,26501
2728,emilbillberg,2,0.00755,19960,75.31791,26501
2729,Emmaka9,2,0.00755,19962,75.32546,26501
2730,emoxam,2,0.00755,19964,75.33301,26501
2731,En-Haya,2,0.00755,19966,75.34055,26501
2732,enjoycx,2,0.00755,19968,75.34810,26501
2733,enochlo,2,0.00755,19970,75.35565,26501
2734,enzoqtvf,2,0.00755,19972,75.36319,26501
2735,eppppi,2,0.00755,19974,75.37074,26501
2736,erchirag,2,0.00755,19976,75.37829,26501
2737,erdemiru,2,0.00755,19978,75.38583,26501
2738,ericgoode,2,0.00755,19980,75.39338,26501
2739,ericgraf,2,0.00755,19982,75.40093,26501
2740,EricSoroos,2,0.00755,19984,75.40848,26501
2741,Eulodos,2,0.00755,19986,75.41602,26501
2742,eurythmia,2,0.00755,19988,75.42357,26501
2743,EutiziStefano,2,0.00755,19990,75.43112,26501
2744,Evedel,2,0.00755,19992,75.43866,26501
2745,evercast-mahesh2021,2,0.00755,19994,75.44621,26501
2746,Ewarren7,2,0.00755,19996,75.45376,26501
2747,explore900620,2,0.00755,19998,75.46130,26501
2748,ezorita,2,0.00755,20000,75.46885,26501
2749,f0rodo,2,0.00755,20002,75.47640,26501
2750,fabiomirmar,2,0.00755,20004,75.48394,26501
2751,fahurox,2,0.00755,20006,75.49149,26501
2752,FaQQQ,2,0.00755,20008,75.49904,26501
2753,farhadkh000,2,0.00755,20010,75.50658,26501
2754,faysh,2,0.00755,20012,75.51413,26501
2755,f-blass,2,0.00755,20014,75.52168,26501
2756,FedorSabeshkin,2,0.00755,20016,75.52923,26501
2757,feelepxyz,2,0.00755,20018,75.53677,26501
2758,feluelle,2,0.00755,20020,75.54432,26501
2759,fengyuanyu1,2,0.00755,20022,75.55187,26501
2760,FerencoVonMatterhorn,2,0.00755,20024,75.55941,26501
2761,FerencTothBARB,2,0.00755,20026,75.56696,26501
2762,findAkash,2,0.00755,20028,75.57451,26501
2763,FirelightFlagboy,2,0.00755,20030,75.58205,26501
2764,fkaanoz,2,0.00755,20032,75.58960,26501
2765,fleeco,2,0.00755,20034,75.59715,26501
2766,flokoenig,2,0.00755,20036,75.60469,26501
2767,FlonFl,2,0.00755,20038,75.61224,26501
2768,florianmutter,2,0.00755,20040,75.61979,26501
2769,flxxyz,2,0.00755,20042,75.62733,26501
2770,fmassot,2,0.00755,20044,75.63488,26501
2771,fooforge,2,0.00755,20046,75.64243,26501
2772,foolishhumans,2,0.00755,20048,75.64998,26501
2773,forosme,2,0.00755,20050,75.65752,26501
2774,Fouz,2,0.00755,20052,75.66507,26501
2775,frankdejonge,2,0.00755,20054,75.67262,26501
2776,frankhorv,2,0.00755,20056,75.68016,26501
2777,frankspeak32,2,0.00755,20058,75.68771,26501
2778,frankyang-code4fun,2,0.00755,20060,75.69526,26501
2779,frivoire,2,0.00755,20062,75.70280,26501
2780,fr-Pursuit,2,0.00755,20064,75.71035,26501
2781,fsalvini,2,0.00755,20066,75.71790,26501
2782,fschrempf,2,0.00755,20068,75.72544,26501
2783,fsedano,2,0.00755,20070,75.73299,26501
2784,ftsxd,2,0.00755,20072,75.74054,26501
2785,funbringer,2,0.00755,20074,75.74808,26501
2786,g1raffi,2,0.00755,20076,75.75563,26501
2787,gacerioni,2,0.00755,20078,75.76318,26501
2788,galibozek,2,0.00755,20080,75.77073,26501
2789,Ganesh-Ponipireddy,2,0.00755,20082,75.77827,26501
2790,ganyyy,2,0.00755,20084,75.78582,26501
2791,gao-artur,2,0.00755,20086,75.79337,26501
2792,garceger,2,0.00755,20088,75.80091,26501
2793,garimachhabra20,2,0.00755,20090,75.80846,26501
2794,garima-n,2,0.00755,20092,75.81601,26501
2795,garymalaysia,2,0.00755,20094,75.82355,26501
2796,Gauravkumar2701,2,0.00755,20096,75.83110,26501
2797,Gawel-Szymanski,2,0.00755,20098,75.83865,26501
2798,gbajson,2,0.00755,20100,75.84619,26501
2799,gchait,2,0.00755,20102,75.85374,26501
2800,gdavison,2,0.00755,20104,75.86129,26501
2801,Geczy,2,0.00755,20106,75.86884,26501
2802,geier,2,0.00755,20108,75.87638,26501
2803,gelangollas,2,0.00755,20110,75.88393,26501
2804,gelpenaddict,2,0.00755,20112,75.89148,26501
2805,gengweifeng,2,0.00755,20114,75.89902,26501
2806,geukhan,2,0.00755,20116,75.90657,26501
2807,gfes980615,2,0.00755,20118,75.91412,26501
2808,gfigueroa,2,0.00755,20120,75.92166,26501
2809,GfxKai,2,0.00755,20122,75.92921,26501
2810,giacomov,2,0.00755,20124,75.93676,26501
2811,giaplv57,2,0.00755,20126,75.94430,26501
2812,gibizer,2,0.00755,20128,75.95185,26501
2813,gibsondan,2,0.00755,20130,75.95940,26501
2814,giolf,2,0.00755,20132,75.96694,26501
2815,GiovanniSM20,2,0.00755,20134,75.97449,26501
2816,GirishShwetha,2,0.00755,20136,75.98204,26501
2817,gittihub123,2,0.00755,20138,75.98959,26501
2818,git-zjx,2,0.00755,20140,75.99713,26501
2819,gjanco,2,0.00755,20142,76.00468,26501
2820,gjerryfe,2,0.00755,20144,76.01223,26501
2821,glokta1,2,0.00755,20146,76.01977,26501
2822,gmarcot,2,0.00755,20148,76.02732,26501
2823,gmariette,2,0.00755,20150,76.03487,26501
2824,gocapa,2,0.00755,20152,76.04241,26501
2825,Goldziher,2,0.00755,20154,76.04996,26501
2826,goodosoft,2,0.00755,20156,76.05751,26501
2827,GotoRen,2,0.00755,20158,76.06505,26501
2828,gpshead,2,0.00755,20160,76.07260,26501
2829,grainrigi,2,0.00755,20162,76.08015,26501
2830,grao1991,2,0.00755,20164,76.08769,26501
2831,greenorca,2,0.00755,20166,76.09524,26501
2832,GretUp,2,0.00755,20168,76.10279,26501
2833,grimz-ly,2,0.00755,20170,76.11034,26501
2834,grinbvi,2,0.00755,20172,76.11788,26501
2835,grom-42,2,0.00755,20174,76.12543,26501
2836,gs80140,2,0.00755,20176,76.13298,26501
2837,gsantoro,2,0.00755,20178,76.14052,26501
2838,g-sponda,2,0.00755,20180,76.14807,26501
2839,GuddyTech,2,0.00755,20182,76.15562,26501
2840,Gusicun,2,0.00755,20184,76.16316,26501
2841,gusyag,2,0.00755,20186,76.17071,26501
2842,guydolinksy,2,0.00755,20188,76.17826,26501
2843,haasad,2,0.00755,20190,76.18580,26501
2844,hackeramitrajpoot,2,0.00755,20192,76.19335,26501
2845,hackersean,2,0.00755,20194,76.20090,26501
2846,hadusam,2,0.00755,20196,76.20844,26501
2847,hailpis1,2,0.00755,20198,76.21599,26501
2848,hajnalmt,2,0.00755,20200,76.22354,26501
2849,hamzamaan,2,0.00755,20202,76.23109,26501
2850,HamzaMasood1,2,0.00755,20204,76.23863,26501
2851,HanquanHq,2,0.00755,20206,76.24618,26501
2852,Hardik29,2,0.00755,20208,76.25373,26501
2853,Harisalghifary,2,0.00755,20210,76.26127,26501
2854,harsha1163,2,0.00755,20212,76.26882,26501
2855,harshraj22,2,0.00755,20214,76.27637,26501
2856,harytfw,2,0.00755,20216,76.28391,26501
2857,Hatament,2,0.00755,20218,76.29146,26501
2858,hauju,2,0.00755,20220,76.29901,26501
2859,headcheater,2,0.00755,20222,76.30655,26501
2860,HehuaTang,2,0.00755,20224,76.31410,26501
2861,helloxubo,2,0.00755,20226,76.32165,26501
2862,henrahmagix,2,0.00755,20228,76.32920,26501
2863,hermannpencole,2,0.00755,20230,76.33674,26501
2864,Heronal,2,0.00755,20232,76.34429,26501
2865,heymde0x541,2,0.00755,20234,76.35184,26501
2866,HeYuqiu,2,0.00755,20236,76.35938,26501
2867,hg-hyy,2,0.00755,20238,76.36693,26501
2868,higels,2,0.00755,20240,76.37448,26501
2869,himeshkothari,2,0.00755,20242,76.38202,26501
2870,hnikt-jonasfh,2,0.00755,20244,76.38957,26501
2871,hn-tma,2,0.00755,20246,76.39712,26501
2872,Hollerweger,2,0.00755,20248,76.40466,26501
2873,horahoradev,2,0.00755,20250,76.41221,26501
2874,Houssem-Esprit,2,0.00755,20252,76.41976,26501
2875,hpeters83,2,0.00755,20254,76.42730,26501
2876,hshahar,2,0.00755,20256,76.43485,26501
2877,hstoresin,2,0.00755,20258,76.44240,26501
2878,huangjun0210,2,0.00755,20260,76.44995,26501
2879,hueyvle,2,0.00755,20262,76.45749,26501
2880,hunterlong,2,0.00755,20264,76.46504,26501
2881,Hutcherson1,2,0.00755,20266,76.47259,26501
2882,hutchig,2,0.00755,20268,76.48013,26501
2883,huynhtehoa,2,0.00755,20270,76.48768,26501
2884,hyeyoung-leee,2,0.00755,20272,76.49523,26501
2885,hyorch,2,0.00755,20274,76.50277,26501
2886,ibarrick,2,0.00755,20276,76.51032,26501
2887,idofsubash,2,0.00755,20278,76.51787,26501
2888,ifeulner,2,0.00755,20280,76.52541,26501
2889,imagekitio,2,0.00755,20282,76.53296,26501
2890,imflash217,2,0.00755,20284,76.54051,26501
2891,ImoutoChan,2,0.00755,20286,76.54805,26501
2892,imoyakin,2,0.00755,20288,76.55560,26501
2893,imzyxwvu,2,0.00755,20290,76.56315,26501
2894,InfiniteLife,2,0.00755,20292,76.57070,26501
2895,inspur-wyq,2,0.00755,20294,76.57824,26501
2896,Irakus,2,0.00755,20296,76.58579,26501
2897,Isaac-Matthews,2,0.00755,20298,76.59334,26501
2898,Isenr,2,0.00755,20300,76.60088,26501
2899,isikemre,2,0.00755,20302,76.60843,26501
2900,iskifogl,2,0.00755,20304,76.61598,26501
2901,isyinun,2,0.00755,20306,76.62352,26501
2902,iterable-company,2,0.00755,20308,76.63107,26501
2903,itsme2980,2,0.00755,20310,76.63862,26501
2904,ItsPiyusha,2,0.00755,20312,76.64616,26501
2905,ivandelic,2,0.00755,20314,76.65371,26501
2906,ivyswen,2,0.00755,20316,76.66126,26501
2907,izayadr,2,0.00755,20318,76.66880,26501
2908,j0ck1e,2,0.00755,20320,76.67635,26501
2909,j4nsp,2,0.00755,20322,76.68390,26501
2910,jacek-czernik,2,0.00755,20324,76.69145,26501
2911,jaceksocha,2,0.00755,20326,76.69899,26501
2912,jackstine,2,0.00755,20328,76.70654,26501
2913,jadahbytes,2,0.00755,20330,76.71409,26501
2914,jagadhees-ravi,2,0.00755,20332,76.72163,26501
2915,jagyas,2,0.00755,20334,76.72918,26501
2916,jakestonelater,2,0.00755,20336,76.73673,26501
2917,jakobkolb,2,0.00755,20338,76.74427,26501
2918,janasu71,2,0.00755,20340,76.75182,26501
2919,janchristian-haddorp,2,0.00755,20342,76.75937,26501
2920,Janvi-Thakkar,2,0.00755,20344,76.76691,26501
2921,jasase,2,0.00755,20346,76.77446,26501
2922,jason1004,2,0.00755,20348,76.78201,26501
2923,jasonhudgins,2,0.00755,20350,76.78956,26501
2924,Jay9625,2,0.00755,20352,76.79710,26501
2925,jay-annapureddy,2,0.00755,20354,76.80465,26501
2926,JayCuthrell,2,0.00755,20356,76.81220,26501
2927,jayoungers,2,0.00755,20358,76.81974,26501
2928,jayzziebone,2,0.00755,20360,76.82729,26501
2929,jbkyang-nvi,2,0.00755,20362,76.83484,26501
2930,jbohanon,2,0.00755,20364,76.84238,26501
2931,JBrejnholt,2,0.00755,20366,76.84993,26501
2932,jdhanota,2,0.00755,20368,76.85748,26501
2933,jeanbaptiste-brasselet,2,0.00755,20370,76.86502,26501
2934,jeansimonbarry,2,0.00755,20372,76.87257,26501
2935,JefferoNW,2,0.00755,20374,76.88012,26501
2936,jenden,2,0.00755,20376,76.88766,26501
2937,jeongkyu,2,0.00755,20378,76.89521,26501
2938,jessereich-mcs,2,0.00755,20380,76.90276,26501
2939,jessonzj,2,0.00755,20382,76.91031,26501
2940,jete-vian,2,0.00755,20384,76.91785,26501
2941,jethinho,2,0.00755,20386,76.92540,26501
2942,jevontane,2,0.00755,20388,76.93295,26501
2943,jezekra1,2,0.00755,20390,76.94049,26501
2944,jfiore-im,2,0.00755,20392,76.94804,26501
2945,JFMeeks,2,0.00755,20394,76.95559,26501
2946,jhodnett2,2,0.00755,20396,76.96313,26501
2947,jhsswl,2,0.00755,20398,76.97068,26501
2948,jian2008,2,0.00755,20400,76.97823,26501
2949,jiangwu10057,2,0.00755,20402,76.98577,26501
2950,jiayoukun,2,0.00755,20404,76.99332,26501
2951,jin-ahn,2,0.00755,20406,77.00087,26501
2952,jinopl,2,0.00755,20408,77.00841,26501
2953,jjsiv,2,0.00755,20410,77.01596,26501
2954,jkgonzio,2,0.00755,20412,77.02351,26501
2955,jk-he,2,0.00755,20414,77.03106,26501
2956,jlange-koch,2,0.00755,20416,77.03860,26501
2957,jlonganecker,2,0.00755,20418,77.04615,26501
2958,joaorzz,2,0.00755,20420,77.05370,26501
2959,jocrau,2,0.00755,20422,77.06124,26501
2960,joebelford,2,0.00755,20424,77.06879,26501
2961,joepke,2,0.00755,20426,77.07634,26501
2962,johndbro1,2,0.00755,20428,77.08388,26501
2963,johnstonmatt,2,0.00755,20430,77.09143,26501
2964,jon4hz,2,0.00755,20432,77.09898,26501
2965,JonasJes,2,0.00755,20434,77.10652,26501
2966,jonchammer,2,0.00755,20436,77.11407,26501
2967,jonoabroad,2,0.00755,20438,77.12162,26501
2968,jonquil2002,2,0.00755,20440,77.12916,26501
2969,jordansamuels,2,0.00755,20442,77.13671,26501
2970,jorisjumanne,2,0.00755,20444,77.14426,26501
2971,joschiwald,2,0.00755,20446,77.15181,26501
2972,JoshChristie,2,0.00755,20448,77.15935,26501
2973,Jovons,2,0.00755,20450,77.16690,26501
2974,jqiuyin,2,0.00755,20452,77.17445,26501
2975,jroose,2,0.00755,20454,77.18199,26501
2976,jrummler,2,0.00755,20456,77.18954,26501
2977,jseko,2,0.00755,20458,77.19709,26501
2978,jsinme,2,0.00755,20460,77.20463,26501
2979,JSPRH,2,0.00755,20462,77.21218,26501
2980,JusteenR,2,0.00755,20464,77.21973,26501
2981,JvD-Ericsson,2,0.00755,20466,77.22727,26501
2982,jvillal-amp,2,0.00755,20468,77.23482,26501
2983,jvizier,2,0.00755,20470,77.24237,26501
2984,jyf2118,2,0.00755,20472,77.24992,26501
2985,kailashchoudhary11,2,0.00755,20474,77.25746,26501
2986,Kajot-dev,2,0.00755,20476,77.26501,26501
2987,kalel-k,2,0.00755,20478,77.27256,26501
2988,kamaraj-muthupandian,2,0.00755,20480,77.28010,26501
2989,kamui-fin,2,0.00755,20482,77.28765,26501
2990,KanchiShimono,2,0.00755,20484,77.29520,26501
2991,kangsan0420,2,0.00755,20486,77.30274,26501
2992,kapheneio,2,0.00755,20488,77.31029,26501
2993,karinakanjaria,2,0.00755,20490,77.31784,26501
2994,karmichand,2,0.00755,20492,77.32538,26501
2995,karster,2,0.00755,20494,77.33293,26501
2996,Kartik-Mohan,2,0.00755,20496,77.34048,26501
2997,kavinnath,2,0.00755,20498,77.34802,26501
2998,Kd-Here,2,0.00755,20500,77.35557,26501
2999,keefeleen,2,0.00755,20502,77.36312,26501
3000,keerthanavenky,2,0.00755,20504,77.37067,26501
3001,KenCox94,2,0.00755,20506,77.37821,26501
3002,KenMacD,2,0.00755,20508,77.38576,26501
3003,kenny-tan,2,0.00755,20510,77.39331,26501
3004,kerian1,2,0.00755,20512,77.40085,26501
3005,kettenbach-it,2,0.00755,20514,77.40840,26501
3006,KevDBG,2,0.00755,20516,77.41595,26501
3007,KevinBonilla,2,0.00755,20518,77.42349,26501
3008,KevinCammarata,2,0.00755,20520,77.43104,26501
3009,KevinPoole,2,0.00755,20522,77.43859,26501
3010,kewshah4,2,0.00755,20524,77.44613,26501
3011,KFearsoff,2,0.00755,20526,77.45368,26501
3012,khoinguyen,2,0.00755,20528,77.46123,26501
3013,khokho,2,0.00755,20530,77.46877,26501
3014,khushboomittal34,2,0.00755,20532,77.47632,26501
3015,kiemtcb,2,0.00755,20534,77.48387,26501
3016,killsnow,2,0.00755,20536,77.49142,26501
3017,kim-sehoon,2,0.00755,20538,77.49896,26501
3018,kingsquirrel152,2,0.00755,20540,77.50651,26501
3019,KiranReddy230,2,0.00755,20542,77.51406,26501
3020,Kisuke-CZE,2,0.00755,20544,77.52160,26501
3021,k-jingyang,2,0.00755,20546,77.52915,26501
3022,kkumarDMS,2,0.00755,20548,77.53670,26501
3023,klementi,2,0.00755,20550,77.54424,26501
3024,kmpm,2,0.00755,20552,77.55179,26501
3025,knadendla,2,0.00755,20554,77.55934,26501
3026,knanao,2,0.00755,20556,77.56688,26501
3027,Kobus-Smit,2,0.00755,20558,77.57443,26501
3028,Koji-Study,2,0.00755,20560,77.58198,26501
3029,korableg,2,0.00755,20562,77.58952,26501
3030,kotloki,2,0.00755,20564,77.59707,26501
3031,Kotnstantin,2,0.00755,20566,77.60462,26501
3032,koutselakismanos,2,0.00755,20568,77.61217,26501
3033,kportertx,2,0.00755,20570,77.61971,26501
3034,krajorama,2,0.00755,20572,77.62726,26501
3035,kranurag78,2,0.00755,20574,77.63481,26501
3036,KrzysztofPajak,2,0.00755,20576,77.64235,26501
3037,ksumag,2,0.00755,20578,77.64990,26501
3038,kthguru,2,0.00755,20580,77.65745,26501
3039,kunalspatil,2,0.00755,20582,77.66499,26501
3040,kurokobo,2,0.00755,20584,77.67254,26501
3041,LachlanStuart,2,0.00755,20586,77.68009,26501
3042,lassizci,2,0.00755,20588,77.68763,26501
3043,lav-kush,2,0.00755,20590,77.69518,26501
3044,leelavathidh192,2,0.00755,20592,77.70273,26501
3045,legorie,2,0.00755,20594,77.71028,26501
3046,lehrig,2,0.00755,20596,77.71782,26501
3047,LeonardoWW,2,0.00755,20598,77.72537,26501
3048,lewinkedrs,2,0.00755,20600,77.73292,26501
3049,lewisushindi,2,0.00755,20602,77.74046,26501
3050,Liam929,2,0.00755,20604,77.74801,26501
3051,LiamLea,2,0.00755,20606,77.75556,26501
3052,librick,2,0.00755,20608,77.76310,26501
3053,liiujinfu,2,0.00755,20610,77.77065,26501
3054,lindeskar,2,0.00755,20612,77.77820,26501
3055,linhbkhn95,2,0.00755,20614,77.78574,26501
3056,lisachenko-indriver,2,0.00755,20616,77.79329,26501
3057,littlejo,2,0.00755,20618,77.80084,26501
3058,LIZEJU,2,0.00755,20620,77.80838,26501
3059,LizhenQiangCOOL,2,0.00755,20622,77.81593,26501
3060,lkishalmi,2,0.00755,20624,77.82348,26501
3061,lluczaj,2,0.00755,20626,77.83103,26501
3062,LonersBoy,2,0.00755,20628,77.83857,26501
3063,LoPan455,2,0.00755,20630,77.84612,26501
3064,lordgordon,2,0.00755,20632,77.85367,26501
3065,LosaMiguel,2,0.00755,20634,77.86121,26501
3066,lsoft-bho,2,0.00755,20636,77.86876,26501
3067,lstrojny,2,0.00755,20638,77.87631,26501
3068,lualvare,2,0.00755,20640,77.88385,26501
3069,LucasMali,2,0.00755,20642,77.89140,26501
3070,luddite516,2,0.00755,20644,77.89895,26501
3071,ludomikula,2,0.00755,20646,77.90649,26501
3072,luhi-DT,2,0.00755,20648,77.91404,26501
3073,LuisCarlos-104171,2,0.00755,20650,77.92159,26501
3074,luisico,2,0.00755,20652,77.92913,26501
3075,luismiguelsaez,2,0.00755,20654,77.93668,26501
3076,luismy,2,0.00755,20656,77.94423,26501
3077,LukasNajman,2,0.00755,20658,77.95178,26501
3078,lukasstockner,2,0.00755,20660,77.95932,26501
3079,luochenzc,2,0.00755,20662,77.96687,26501
3080,luxe,2,0.00755,20664,77.97442,26501
3081,lyona-lyo,2,0.00755,20666,77.98196,26501
3082,lyoung-confluent,2,0.00755,20668,77.98951,26501
3083,ly-wo,2,0.00755,20670,77.99706,26501
3084,lzhang2015,2,0.00755,20672,78.00460,26501
3085,maddie-j,2,0.00755,20674,78.01215,26501
3086,madianas21,2,0.00755,20676,78.01970,26501
3087,mahiyad,2,0.00755,20678,78.02724,26501
3088,MahrRah,2,0.00755,20680,78.03479,26501
3089,mai93,2,0.00755,20682,78.04234,26501
3090,MalHaak,2,0.00755,20684,78.04988,26501
3091,mananpreetsingh,2,0.00755,20686,78.05743,26501
3092,manishsat,2,0.00755,20688,78.06498,26501
3093,mansi1597,2,0.00755,20690,78.07253,26501
3094,manuelver,2,0.00755,20692,78.08007,26501
3095,manuks,2,0.00755,20694,78.08762,26501
3096,maomaoliu,2,0.00755,20696,78.09517,26501
3097,maoyutao,2,0.00755,20698,78.10271,26501
3098,marcecan,2,0.00755,20700,78.11026,26501
3099,marcuskohlberg,2,0.00755,20702,78.11781,26501
3100,MargaretKrutikova,2,0.00755,20704,78.12535,26501
3101,marianobrc,2,0.00755,20706,78.13290,26501
3102,markercm,2,0.00755,20708,78.14045,26501
3103,markfergy,2,0.00755,20710,78.14799,26501
3104,markhildreth-gravity,2,0.00755,20712,78.15554,26501
3105,markwu010,2,0.00755,20714,78.16309,26501
3106,Martinprobu,2,0.00755,20716,78.17064,26501
3107,martinraison,2,0.00755,20718,78.17818,26501
3108,marverix,2,0.00755,20720,78.18573,26501
3109,marvinpeter-kisters,2,0.00755,20722,78.19328,26501
3110,masyutka,2,0.00755,20724,78.20082,26501
3111,mateusaueressig,2,0.00755,20726,78.20837,26501
3112,mathias-muench,2,0.00755,20728,78.21592,26501
3113,mathieudruart,2,0.00755,20730,78.22346,26501
3114,MatinKarbasioun,2,0.00755,20732,78.23101,26501
3115,matthewei,2,0.00755,20734,78.23856,26501
3116,MatthewJamesBoyle,2,0.00755,20736,78.24610,26501
3117,matthewjwhite,2,0.00755,20738,78.25365,26501
3118,mattk-ce,2,0.00755,20740,78.26120,26501
3119,MattMcL4475,2,0.00755,20742,78.26874,26501
3120,matt-pei,2,0.00755,20744,78.27629,26501
3121,maxday,2,0.00755,20746,78.28384,26501
3122,MaxImbrox,2,0.00755,20748,78.29139,26501
3123,Maydaer,2,0.00755,20750,78.29893,26501
3124,mc956759,2,0.00755,20752,78.30648,26501
3125,MDauendorffer,2,0.00755,20754,78.31403,26501
3126,mdimarino,2,0.00755,20756,78.32157,26501
3127,meesii,2,0.00755,20758,78.32912,26501
3128,Mehranh,2,0.00755,20760,78.33667,26501
3129,mehvaibh,2,0.00755,20762,78.34421,26501
3130,Mesmer88,2,0.00755,20764,78.35176,26501
3131,metheu,2,0.00755,20766,78.35931,26501
3132,mfosterrox,2,0.00755,20768,78.36685,26501
3133,mhbitman,2,0.00755,20770,78.37440,26501
3134,mhmast,2,0.00755,20772,78.38195,26501
3135,michaelcooke-ithaka,2,0.00755,20774,78.38949,26501
3136,MichaelHuang88,2,0.00755,20776,78.39704,26501
3137,michaelkira,2,0.00755,20778,78.40459,26501
3138,MichaelSasser,2,0.00755,20780,78.41214,26501
3139,MichaelXcc,2,0.00755,20782,78.41968,26501
3140,MichalCz,2,0.00755,20784,78.42723,26501
3141,michapojo,2,0.00755,20786,78.43478,26501
3142,michealliang123,2,0.00755,20788,78.44232,26501
3143,michieldwitte,2,0.00755,20790,78.44987,26501
3144,michivi,2,0.00755,20792,78.45742,26501
3145,mickvav,2,0.00755,20794,78.46496,26501
3146,mikamboo,2,0.00755,20796,78.47251,26501
3147,mike4500,2,0.00755,20798,78.48006,26501
3148,minghuiyuan,2,0.00755,20800,78.48760,26501
3149,minhduchuynh,2,0.00755,20802,78.49515,26501
3150,Minhir,2,0.00755,20804,78.50270,26501
3151,mirajraju,2,0.00755,20806,78.51024,26501
3152,mirzaprangon,2,0.00755,20808,78.51779,26501
3153,mitchcail,2,0.00755,20810,78.52534,26501
3154,mkarise,2,0.00755,20812,78.53289,26501
3155,mkoellges,2,0.00755,20814,78.54043,26501
3156,mkonterS,2,0.00755,20816,78.54798,26501
3157,mlehotsky,2,0.00755,20818,78.55553,26501
3158,mmacedoaraujo,2,0.00755,20820,78.56307,26501
3159,mmasiuk,2,0.00755,20822,78.57062,26501
3160,m-moris,2,0.00755,20824,78.57817,26501
3161,MohamedFAhmed,2,0.00755,20826,78.58571,26501
3162,MohammadrezaNasrabadi,2,0.00755,20828,78.59326,26501
3163,mohania17,2,0.00755,20830,78.60081,26501
3164,momocg,2,0.00755,20832,78.60835,26501
3165,monfresh,2,0.00755,20834,78.61590,26501
3166,MonkzCode,2,0.00755,20836,78.62345,26501
3167,mookie-,2,0.00755,20838,78.63100,26501
3168,mootaz11,2,0.00755,20840,78.63854,26501
3169,moozooooo,2,0.00755,20842,78.64609,26501
3170,movestill,2,0.00755,20844,78.65364,26501
3171,mperry2,2,0.00755,20846,78.66118,26501
3172,mpeters-tha,2,0.00755,20848,78.66873,26501
3173,mporracindie,2,0.00755,20850,78.67628,26501
3174,mprzybylski,2,0.00755,20852,78.68382,26501
3175,mrajcok,2,0.00755,20854,78.69137,26501
3176,mrentier,2,0.00755,20856,78.69892,26501
3177,MRIservice,2,0.00755,20858,78.70646,26501
3178,mrsangjunboon2018,2,0.00755,20860,78.71401,26501
3179,MrSpoocy,2,0.00755,20862,78.72156,26501
3180,mschirrmeister,2,0.00755,20864,78.72910,26501
3181,msobkowiak-olx,2,0.00755,20866,78.73665,26501
3182,msw-kialo,2,0.00755,20868,78.74420,26501
3183,mtaobiz,2,0.00755,20870,78.75175,26501
3184,mtbennett-godaddy,2,0.00755,20872,78.75929,26501
3185,Muddam234,2,0.00755,20874,78.76684,26501
3186,MuhendisBey,2,0.00755,20876,78.77439,26501
3187,muraliprasadece,2,0.00755,20878,78.78193,26501
3188,musayldrm11,2,0.00755,20880,78.78948,26501
3189,mwieczorkiewicz,2,0.00755,20882,78.79703,26501
3190,mwoodson-coinbasecloud,2,0.00755,20884,78.80457,26501
3191,mxmehl,2,0.00755,20886,78.81212,26501
3192,myasin786786,2,0.00755,20888,78.81967,26501
3193,myftiu67,2,0.00755,20890,78.82721,26501
3194,MysteryZ,2,0.00755,20892,78.83476,26501
3195,n9,2,0.00755,20894,78.84231,26501
3196,Nagarajan0396,2,0.00755,20896,78.84985,26501
3197,nalshamaajc,2,0.00755,20898,78.85740,26501
3198,Namjoofar,2,0.00755,20900,78.86495,26501
3199,nanalncux,2,0.00755,20902,78.87250,26501
3200,nandhasa1986,2,0.00755,20904,78.88004,26501
3201,nanmegnealain,2,0.00755,20906,78.88759,26501
3202,naoya-aizawa-g,2,0.00755,20908,78.89514,26501
3203,napoleonp,2,0.00755,20910,78.90268,26501
3204,NathanKarthik1996,2,0.00755,20912,78.91023,26501
3205,Nbarola,2,0.00755,20914,78.91778,26501
3206,nctruser,2,0.00755,20916,78.92532,26501
3207,ncwuping,2,0.00755,20918,78.93287,26501
3208,neeraj-n-singh,2,0.00755,20920,78.94042,26501
3209,neildobson-au,2,0.00755,20922,78.94796,26501
3210,neilrao-ey,2,0.00755,20924,78.95551,26501
3211,neilspage2,2,0.00755,20926,78.96306,26501
3212,NenadSteric,2,0.00755,20928,78.97060,26501
3213,neottil,2,0.00755,20930,78.97815,26501
3214,NexusNull,2,0.00755,20932,78.98570,26501
3215,ngc703,2,0.00755,20934,78.99325,26501
3216,NgKSS,2,0.00755,20936,79.00079,26501
3217,ngoctran1,2,0.00755,20938,79.00834,26501
3218,NhokCrazy199,2,0.00755,20940,79.01589,26501
3219,nickdig,2,0.00755,20942,79.02343,26501
3220,nickleach,2,0.00755,20944,79.03098,26501
3221,nielifeng,2,0.00755,20946,79.03853,26501
3222,niharrathod,2,0.00755,20948,79.04607,26501
3223,nikashnarula,2,0.00755,20950,79.05362,26501
3224,nikgattu,2,0.00755,20952,79.06117,26501
3225,nik-netlox,2,0.00755,20954,79.06871,26501
3226,niting-dremio,2,0.00755,20956,79.07626,26501
3227,NivethaJayaveeran,2,0.00755,20958,79.08381,26501
3228,nlakshmipathy,2,0.00755,20960,79.09136,26501
3229,NoctivagusObitus,2,0.00755,20962,79.09890,26501
3230,nomagick,2,0.00755,20964,79.10645,26501
3231,nraju-branch,2,0.00755,20966,79.11400,26501
3232,ntarocco,2,0.00755,20968,79.12154,26501
3233,nullren,2,0.00755,20970,79.12909,26501
3234,NuSkooler,2,0.00755,20972,79.13664,26501
3235,nv-alaiacano,2,0.00755,20974,79.14418,26501
3236,oasiszeng,2,0.00755,20976,79.15173,26501
3237,obloquy,2,0.00755,20978,79.15928,26501
3238,oconnormj,2,0.00755,20980,79.16682,26501
3239,OlgaMaciaszek,2,0.00755,20982,79.17437,26501
3240,olga-salesloft,2,0.00755,20984,79.18192,26501
3241,oliverswitzer,2,0.00755,20986,79.18946,26501
3242,omarfakhreddine,2,0.00755,20988,79.19701,26501
3243,omarkohl,2,0.00755,20990,79.20456,26501
3244,omelchukvladyslav,2,0.00755,20992,79.21211,26501
3245,ondrejkorol,2,0.00755,20994,79.21965,26501
3246,opt-liang,2,0.00755,20996,79.22720,26501
3247,ormosias,2,0.00755,20998,79.23475,26501
3248,or-navon,2,0.00755,21000,79.24229,26501
3249,Orogenesis,2,0.00755,21002,79.24984,26501
3250,osmanovv,2,0.00755,21004,79.25739,26501
3251,osyduck,2,0.00755,21006,79.26493,26501
3252,OurBoy22,2,0.00755,21008,79.27248,26501
3253,Owenxh,2,0.00755,21010,79.28003,26501
3254,Owez,2,0.00755,21012,79.28757,26501
3255,OzgurBagci,2,0.00755,21014,79.29512,26501
3256,Ozkee,2,0.00755,21016,79.30267,26501
3257,p25101995,2,0.00755,21018,79.31021,26501
3258,p33t,2,0.00755,21020,79.31776,26501
3259,pablofontanilla,2,0.00755,21022,79.32531,26501
3260,pacokleitz,2,0.00755,21024,79.33286,26501
3261,pakhip09,2,0.00755,21026,79.34040,26501
3262,pallintipremkumar,2,0.00755,21028,79.34795,26501
3263,PanyalaSainathReddy,2,0.00755,21030,79.35550,26501
3264,paolostancato,2,0.00755,21032,79.36304,26501
3265,ParkerRedford,2,0.00755,21034,79.37059,26501
3266,parthava-adabala,2,0.00755,21036,79.37814,26501
3267,passionInfinite,2,0.00755,21038,79.38568,26501
3268,patrizok,2,0.00755,21040,79.39323,26501
3269,paul-ohl,2,0.00755,21042,79.40078,26501
3270,Pavankumaryerraji,2,0.00755,21044,79.40832,26501
3271,Pavan-Nambi,2,0.00755,21046,79.41587,26501
3272,pavel-jancik,2,0.00755,21048,79.42342,26501
3273,pavlov2000uk,2,0.00755,21050,79.43096,26501
3274,paylocity-sflanders,2,0.00755,21052,79.43851,26501
3275,pcaldeira-md,2,0.00755,21054,79.44606,26501
3276,pc-tzimmerman,2,0.00755,21056,79.45361,26501
3277,Peilun-Li,2,0.00755,21058,79.46115,26501
3278,pen4,2,0.00755,21060,79.46870,26501
3279,peterhchen,2,0.00755,21062,79.47625,26501
3280,pete-woods,2,0.00755,21064,79.48379,26501
3281,philstahlfeld,2,0.00755,21066,79.49134,26501
3282,phutaneVinayak,2,0.00755,21068,79.49889,26501
3283,picolov,2,0.00755,21070,79.50643,26501
3284,Pierric82,2,0.00755,21072,79.51398,26501
3285,piiq,2,0.00755,21074,79.52153,26501
3286,pinkygangula,2,0.00755,21076,79.52907,26501
3287,piyush280,2,0.00755,21078,79.53662,26501
3288,pkgulati,2,0.00755,21080,79.54417,26501
3289,PKobold,2,0.00755,21082,79.55172,26501
3290,plamen-kutinchev,2,0.00755,21084,79.55926,26501
3291,PlytonRexus,2,0.00755,21086,79.56681,26501
3292,pmcenery,2,0.00755,21088,79.57436,26501
3293,poinsetta789,2,0.00755,21090,79.58190,26501
3294,ponfee,2,0.00755,21092,79.58945,26501
3295,poojasj,2,0.00755,21094,79.59700,26501
3296,poorpy,2,0.00755,21096,79.60454,26501
3297,ppd0705,2,0.00755,21098,79.61209,26501
3298,prajaktas,2,0.00755,21100,79.61964,26501
3299,prakarsh-dt,2,0.00755,21102,79.62718,26501
3300,pramitagautam,2,0.00755,21104,79.63473,26501
3301,pranavarnav2,2,0.00755,21106,79.64228,26501
3302,Pranaynutanix,2,0.00755,21108,79.64982,26501
3303,prasanna-desikank,2,0.00755,21110,79.65737,26501
3304,prateekprshr-nith,2,0.00755,21112,79.66492,26501
3305,programingKing,2,0.00755,21114,79.67247,26501
3306,psalajova,2,0.00755,21116,79.68001,26501
3307,pugmajere,2,0.00755,21118,79.68756,26501
3308,purajit,2,0.00755,21120,79.69511,26501
3309,pureguy0,2,0.00755,21122,79.70265,26501
3310,pwallqvist,2,0.00755,21124,79.71020,26501
3311,PyV-IVL,2,0.00755,21126,79.71775,26501
3312,pzhx521,2,0.00755,21128,79.72529,26501
3313,qihuang0,2,0.00755,21130,79.73284,26501
3314,Qonqn,2,0.00755,21132,79.74039,26501
3315,QualoZe0t,2,0.00755,21134,79.74793,26501
3316,QZB349549482,2,0.00755,21136,79.75548,26501
3317,ra0e,2,0.00755,21138,79.76303,26501
3318,rabbanimdrb,2,0.00755,21140,79.77057,26501
3319,rabellamy,2,0.00755,21142,79.77812,26501
3320,rafaelcoelho,2,0.00755,21144,79.78567,26501
3321,rafaelinmario,2,0.00755,21146,79.79322,26501
3322,rahulroshank,2,0.00755,21148,79.80076,26501
3323,rajatrj16,2,0.00755,21150,79.80831,26501
3324,rajendraindukuri,2,0.00755,21152,79.81586,26501
3325,rajjaiswalsaumya,2,0.00755,21154,79.82340,26501
3326,rakaseth,2,0.00755,21156,79.83095,26501
3327,rakshith210,2,0.00755,21158,79.83850,26501
3328,rAlexandre00,2,0.00755,21160,79.84604,26501
3329,ralpha,2,0.00755,21162,79.85359,26501
3330,ralphotowo,2,0.00755,21164,79.86114,26501
3331,rama534,2,0.00755,21166,79.86868,26501
3332,ramrattle,2,0.00755,21168,79.87623,26501
3333,Rangudu,2,0.00755,21170,79.88378,26501
3334,RaulAlcaraz,2,0.00755,21172,79.89132,26501
3335,ravids,2,0.00755,21174,79.89887,26501
3336,ravi-gopalan-1972,2,0.00755,21176,79.90642,26501
3337,rayate2410,2,0.00755,21178,79.91397,26501
3338,rayella-bergman-okcupid,2,0.00755,21180,79.92151,26501
3339,Razgoldenberg1,2,0.00755,21182,79.92906,26501
3340,razlani,2,0.00755,21184,79.93661,26501
3341,razorness,2,0.00755,21186,79.94415,26501
3342,rbnayax,2,0.00755,21188,79.95170,26501
3343,rchinni-mn,2,0.00755,21190,79.95925,26501
3344,rchoulak,2,0.00755,21192,79.96679,26501
3345,rdb0101,2,0.00755,21194,79.97434,26501
3346,rdramana85,2,0.00755,21196,79.98189,26501
3347,ReeceSwyftx,2,0.00755,21198,79.98943,26501
3348,relaxedleaf,2,0.00755,21200,79.99698,26501
3349,RemcoBlok,2,0.00755,21202,80.00453,26501
3350,renatosc,2,0.00755,21204,80.01208,26501
3351,RicardoAlvialANS,2,0.00755,21206,80.01962,26501
3352,ricardoapl,2,0.00755,21208,80.02717,26501
3353,richardfontana,2,0.00755,21210,80.03472,26501
3354,rigoleto,2,0.00755,21212,80.04226,26501
3355,Rishi6229,2,0.00755,21214,80.04981,26501
3356,rnishtala-sumo,2,0.00755,21216,80.05736,26501
3357,robbe-haesendonck,2,0.00755,21218,80.06490,26501
3358,robotLJW,2,0.00755,21220,80.07245,26501
3359,rodrigovb96,2,0.00755,21222,80.08000,26501
3360,roeizavida,2,0.00755,21224,80.08754,26501
3361,rogdex24,2,0.00755,21226,80.09509,26501
3362,rohit28071992,2,0.00755,21228,80.10264,26501
3363,rohit42412,2,0.00755,21230,80.11018,26501
3364,roldyxoriginal,2,0.00755,21232,80.11773,26501
3365,rolnick,2,0.00755,21234,80.12528,26501
3366,romitzz1,2,0.00755,21236,80.13283,26501
3367,rothwerx,2,0.00755,21238,80.14037,26501
3368,rschlick,2,0.00755,21240,80.14792,26501
3369,Rshep3087,2,0.00755,21242,80.15547,26501
3370,rt-sg,2,0.00755,21244,80.16301,26501
3371,Rubemlrm,2,0.00755,21246,80.17056,26501
3372,rudyares,2,0.00755,21248,80.17811,26501
3373,rupeshnemade,2,0.00755,21250,80.18565,26501
3374,rushi-12320,2,0.00755,21252,80.19320,26501
3375,russlevy,2,0.00755,21254,80.20075,26501
3376,rvlane4,2,0.00755,21256,80.20829,26501
3377,R-Yanchik,2,0.00755,21258,80.21584,26501
3378,Ryang20718,2,0.00755,21260,80.22339,26501
3379,ryo-ma,2,0.00755,21262,80.23093,26501
3380,safee60,2,0.00755,21264,80.23848,26501
3381,sagimedina1,2,0.00755,21266,80.24603,26501
3382,sahaparamjit,2,0.00755,21268,80.25358,26501
3383,sahil3471,2,0.00755,21270,80.26112,26501
3384,saidas3524,2,0.00755,21272,80.26867,26501
3385,SalahBellagnaoui,2,0.00755,21274,80.27622,26501
3386,salamer,2,0.00755,21276,80.28376,26501
3387,sam0410,2,0.00755,21278,80.29131,26501
3388,samar08,2,0.00755,21280,80.29886,26501
3389,Sameer166,2,0.00755,21282,80.30640,26501
3390,SamyGhannad,2,0.00755,21284,80.31395,26501
3391,Sandeepchouhan05,2,0.00755,21286,80.32150,26501
3392,sandy0509187,2,0.00755,21288,80.32904,26501
3393,sanjaydebnath,2,0.00755,21290,80.33659,26501
3394,sankarpn,2,0.00755,21292,80.34414,26501
3395,santoseric,2,0.00755,21294,80.35168,26501
3396,sashasushko,2,0.00755,21296,80.35923,26501
3397,SatheesP,2,0.00755,21298,80.36678,26501
3398,satishh1988,2,0.00755,21300,80.37433,26501
3399,satya-devloper,2,0.00755,21302,80.38187,26501
3400,satyampsoni,2,0.00755,21304,80.38942,26501
3401,Saumya132,2,0.00755,21306,80.39697,26501
3402,Saurabh-704,2,0.00755,21308,80.40451,26501
3403,sbahmani,2,0.00755,21310,80.41206,26501
3404,sbowers-gbx,2,0.00755,21312,80.41961,26501
3405,scaledapps,2,0.00755,21314,80.42715,26501
3406,scbrubaker02,2,0.00755,21316,80.43470,26501
3407,Schmuck777,2,0.00755,21318,80.44225,26501
3408,ScottLinnn,2,0.00755,21320,80.44979,26501
3409,sdicke,2,0.00755,21322,80.45734,26501
3410,seanmorton,2,0.00755,21324,80.46489,26501
3411,semihbkgr,2,0.00755,21326,80.47244,26501
3412,Semmu,2,0.00755,21328,80.47998,26501
3413,senani-mayank,2,0.00755,21330,80.48753,26501
3414,SenithDilitha,2,0.00755,21332,80.49508,26501
3415,seppo0010,2,0.00755,21334,80.50262,26501
3416,sergej-laufer,2,0.00755,21336,80.51017,26501
3417,SergiyKolesnikov,2,0.00755,21338,80.51772,26501
3418,Sermelyan,2,0.00755,21340,80.52526,26501
3419,shabharg,2,0.00755,21342,80.53281,26501
3420,shareefj,2,0.00755,21344,80.54036,26501
3421,sharpSteff,2,0.00755,21346,80.54790,26501
3422,shaundaley39,2,0.00755,21348,80.55545,26501
3423,sheldor14,2,0.00755,21350,80.56300,26501
3424,shenben,2,0.00755,21352,80.57054,26501
3425,shenlanzifa,2,0.00755,21354,80.57809,26501
3426,shikha-khandelwa,2,0.00755,21356,80.58564,26501
3427,shilpa87-khushi,2,0.00755,21358,80.59319,26501
3428,Shimrockx,2,0.00755,21360,80.60073,26501
3429,Shinichi-Abe-dev,2,0.00755,21362,80.60828,26501
3430,Shiva2199,2,0.00755,21364,80.61583,26501
3431,Shivam0609,2,0.00755,21366,80.62337,26501
3432,shivamrustagi,2,0.00755,21368,80.63092,26501
3433,shivangbhar,2,0.00755,21370,80.63847,26501
3434,shoot16625,2,0.00755,21372,80.64601,26501
3435,shortcuts,2,0.00755,21374,80.65356,26501
3436,shreyaanjali,2,0.00755,21376,80.66111,26501
3437,ShrutiC-git,2,0.00755,21378,80.66865,26501
3438,Shubham9t9,2,0.00755,21380,80.67620,26501
3439,siggimoo,2,0.00755,21382,80.68375,26501
3440,simonlaw0711,2,0.00755,21384,80.69129,26501
3441,SimonMarechal,2,0.00755,21386,80.69884,26501
3442,simshengqin,2,0.00755,21388,80.70639,26501
3443,sinanub18,2,0.00755,21390,80.71394,26501
3444,sinclairs,2,0.00755,21392,80.72148,26501
3445,singerxt,2,0.00755,21394,80.72903,26501
3446,siparsons,2,0.00755,21396,80.73658,26501
3447,sirantd,2,0.00755,21398,80.74412,26501
3448,SiWafer,2,0.00755,21400,80.75167,26501
3449,sixcolors,2,0.00755,21402,80.75922,26501
3450,sixwaaaay,2,0.00755,21404,80.76676,26501
3451,sjanel,2,0.00755,21406,80.77431,26501
3452,skattoju4,2,0.00755,21408,80.78186,26501
3453,skeilson,2,0.00755,21410,80.78940,26501
3454,sker65,2,0.00755,21412,80.79695,26501
3455,skrypnik-dzencode,2,0.00755,21414,80.80450,26501
3456,slankka,2,0.00755,21416,80.81204,26501
3457,slavomirs,2,0.00755,21418,80.81959,26501
3458,slw07g,2,0.00755,21420,80.82714,26501
3459,smackesey,2,0.00755,21422,80.83469,26501
3460,smah29,2,0.00755,21424,80.84223,26501
3461,snailzed,2,0.00755,21426,80.84978,26501
3462,snakebyte91,2,0.00755,21428,80.85733,26501
3463,soft4rchitecture,2,0.00755,21430,80.86487,26501
3464,softhuafei,2,0.00755,21432,80.87242,26501
3465,sonjinho,2,0.00755,21434,80.87997,26501
3466,sonsmartbear,2,0.00755,21436,80.88751,26501
3467,soukichi,2,0.00755,21438,80.89506,26501
3468,source-transformer,2,0.00755,21440,80.90261,26501
3469,soyacen,2,0.00755,21442,80.91015,26501
3470,speshak,2,0.00755,21444,80.91770,26501
3471,SphinxKnight,2,0.00755,21446,80.92525,26501
3472,SpokeyWheeler,2,0.00755,21448,80.93279,26501
3473,Sreya27,2,0.00755,21450,80.94034,26501
3474,srinivasnm471,2,0.00755,21452,80.94789,26501
3475,srosam,2,0.00755,21454,80.95544,26501
3476,ssunilkkumar,2,0.00755,21456,80.96298,26501
3477,starbops,2,0.00755,21458,80.97053,26501
3478,stawirej,2,0.00755,21460,80.97808,26501
3479,stebbib,2,0.00755,21462,80.98562,26501
3480,SteinRobert,2,0.00755,21464,80.99317,26501
3481,stenio123,2,0.00755,21466,81.00072,26501
3482,StephaneRob,2,0.00755,21468,81.00826,26501
3483,Sti2nd,2,0.00755,21470,81.01581,26501
3484,stilettk,2,0.00755,21472,81.02336,26501
3485,sto,2,0.00755,21474,81.03090,26501
3486,stone1100,2,0.00755,21476,81.03845,26501
3487,stonever,2,0.00755,21478,81.04600,26501
3488,strunzo,2,0.00755,21480,81.05355,26501
3489,subbufrom,2,0.00755,21482,81.06109,26501
3490,subox,2,0.00755,21484,81.06864,26501
3491,sudersank,2,0.00755,21486,81.07619,26501
3492,Suesexy453,2,0.00755,21488,81.08373,26501
3493,sumedhpd,2,0.00755,21490,81.09128,26501
3494,sumitroajiprabowo,2,0.00755,21492,81.09883,26501
3495,sumit-salunke,2,0.00755,21494,81.10637,26501
3496,sungureanu,2,0.00755,21496,81.11392,26501
3497,sunilharipkd,2,0.00755,21498,81.12147,26501
3498,sunxiaobei,2,0.00755,21500,81.12901,26501
3499,Suomea,2,0.00755,21502,81.13656,26501
3500,supakornbabe,2,0.00755,21504,81.14411,26501
3501,supergillis,2,0.00755,21506,81.15165,26501
3502,Supermajestcd,2,0.00755,21508,81.15920,26501
3503,Supporterino,2,0.00755,21510,81.16675,26501
3504,supreethvh,2,0.00755,21512,81.17430,26501
3505,surajrathoresp,2,0.00755,21514,81.18184,26501
3506,Surjendu78,2,0.00755,21516,81.18939,26501
3507,suxiaoxiaomm,2,0.00755,21518,81.19694,26501
3508,suyash-gogte-discovery,2,0.00755,21520,81.20448,26501
3509,swamx,2,0.00755,21522,81.21203,26501
3510,swaradgat19,2,0.00755,21524,81.21958,26501
3511,swy19870105,2,0.00755,21526,81.22712,26501
3512,syphernl,2,0.00755,21528,81.23467,26501
3513,szhengli,2,0.00755,21530,81.24222,26501
3514,taneyland,2,0.00755,21532,81.24976,26501
3515,TaniaFedirko,2,0.00755,21534,81.25731,26501
3516,tanjinx,2,0.00755,21536,81.26486,26501
3517,tanmaysarin,2,0.00755,21538,81.27240,26501
3518,tanphan-vn,2,0.00755,21540,81.27995,26501
3519,tanvircefalo,2,0.00755,21542,81.28750,26501
3520,tatupesonen,2,0.00755,21544,81.29505,26501
3521,TauqeerAhmad104,2,0.00755,21546,81.30259,26501
3522,tbocinec,2,0.00755,21548,81.31014,26501
3523,tbuchaillot,2,0.00755,21550,81.31769,26501
3524,tcx4c70,2,0.00755,21552,81.32523,26501
3525,techxplrorer,2,0.00755,21554,81.33278,26501
3526,Tetita,2,0.00755,21556,81.34033,26501
3527,tgburke,2,0.00755,21558,81.34787,26501
3528,tgoodsell-tempus,2,0.00755,21560,81.35542,26501
3529,tgrondier,2,0.00755,21562,81.36297,26501
3530,thanhnet,2,0.00755,21564,81.37051,26501
3531,Tharolzakariya,2,0.00755,21566,81.37806,26501
3532,thatguyatgithub,2,0.00755,21568,81.38561,26501
3533,thatsankur,2,0.00755,21570,81.39315,26501
3534,thecjd,2,0.00755,21572,81.40070,26501
3535,theEyeD,2,0.00755,21574,81.40825,26501
3536,theiltho,2,0.00755,21576,81.41580,26501
3537,thekief,2,0.00755,21578,81.42334,26501
3538,TheMonolithX64,2,0.00755,21580,81.43089,26501
3539,theobjectivedad,2,0.00755,21582,81.43844,26501
3540,ThomasArts,2,0.00755,21584,81.44598,26501
3541,thomasnemer,2,0.00755,21586,81.45353,26501
3542,tijumat,2,0.00755,21588,81.46108,26501
3543,tillknuesting,2,0.00755,21590,81.46862,26501
3544,timarmstrong,2,0.00755,21592,81.47617,26501
3545,timijntema,2,0.00755,21594,81.48372,26501
3546,timp87,2,0.00755,21596,81.49126,26501
3547,timscharfenort8989,2,0.00755,21598,81.49881,26501
3548,tiny656,2,0.00755,21600,81.50636,26501
3549,tiwisag,2,0.00755,21602,81.51391,26501
3550,tkagn,2,0.00755,21604,81.52145,26501
3551,tkuik,2,0.00755,21606,81.52900,26501
3552,tlqiao,2,0.00755,21608,81.53655,26501
3553,tmpjg,2,0.00755,21610,81.54409,26501
3554,tobiasake,2,0.00755,21612,81.55164,26501
3555,tomaswitek,2,0.00755,21614,81.55919,26501
3556,TomaszMru,2,0.00755,21616,81.56673,26501
3557,Tom-GK,2,0.00755,21618,81.57428,26501
3558,tomkingchen,2,0.00755,21620,81.58183,26501
3559,tonycox,2,0.00755,21622,81.58937,26501
3560,tonyhuangzerohash,2,0.00755,21624,81.59692,26501
3561,topleft,2,0.00755,21626,81.60447,26501
3562,torbenaa,2,0.00755,21628,81.61201,26501
3563,torqataNate,2,0.00755,21630,81.61956,26501
3564,tottiliyt,2,0.00755,21632,81.62711,26501
3565,toxish666,2,0.00755,21634,81.63466,26501
3566,TrayserCassa,2,0.00755,21636,81.64220,26501
3567,TrieBr,2,0.00755,21638,81.64975,26501
3568,troyvit,2,0.00755,21640,81.65730,26501
3569,trpouh,2,0.00755,21642,81.66484,26501
3570,trzejos,2,0.00755,21644,81.67239,26501
3571,tshiyuoo,2,0.00755,21646,81.67994,26501
3572,tsolodov,2,0.00755,21648,81.68748,26501
3573,Tsovak,2,0.00755,21650,81.69503,26501
3574,tt0suzy,2,0.00755,21652,81.70258,26501
3575,tt-mtc,2,0.00755,21654,81.71012,26501
3576,tuong-at-wes,2,0.00755,21656,81.71767,26501
3577,tusharkdev,2,0.00755,21658,81.72522,26501
3578,tvandewalle,2,0.00755,21660,81.73276,26501
3579,twosdai,2,0.00755,21662,81.74031,26501
3580,tylermichael,2,0.00755,21664,81.74786,26501
3581,tynsh,2,0.00755,21666,81.75541,26501
3582,t-yrka,2,0.00755,21668,81.76295,26501
3583,Udi-Hofesh,2,0.00755,21670,81.77050,26501
3584,ulan-yisaev,2,0.00755,21672,81.77805,26501
3585,Unfaced85,2,0.00755,21674,81.78559,26501
3586,ux-AylonS,2,0.00755,21676,81.79314,26501
3587,uyugame,2,0.00755,21678,81.80069,26501
3588,Va-asu,2,0.00755,21680,81.80823,26501
3589,vadim-a-nesterov,2,0.00755,21682,81.81578,26501
3590,vahiddu,2,0.00755,21684,81.82333,26501
3591,ValentinOzanne,2,0.00755,21686,81.83087,26501
3592,Valeriyy,2,0.00755,21688,81.83842,26501
3593,vandry,2,0.00755,21690,81.84597,26501
3594,Vandy-P,2,0.00755,21692,81.85351,26501
3595,vankefr,2,0.00755,21694,81.86106,26501
3596,v-electrolux,2,0.00755,21696,81.86861,26501
3597,vemularamana,2,0.00755,21698,81.87616,26501
3598,venkats51,2,0.00755,21700,81.88370,26501
3599,venukrishna,2,0.00755,21702,81.89125,26501
3600,veronikaBu,2,0.00755,21704,81.89880,26501
3601,Vickydev95,2,0.00755,21706,81.90634,26501
3602,VicThomas,2,0.00755,21708,81.91389,26501
3603,victordavidalarcon,2,0.00755,21710,81.92144,26501
3604,vikasbudhwat,2,0.00755,21712,81.92898,26501
3605,vin01,2,0.00755,21714,81.93653,26501
3606,Virusuki,2,0.00755,21716,81.94408,26501
3607,vishvikkrishnan,2,0.00755,21718,81.95162,26501
3608,VitaliiBabii,2,0.00755,21720,81.95917,26501
3609,vitgorbunov,2,0.00755,21722,81.96672,26501
3610,vivox80pro,2,0.00755,21724,81.97427,26501
3611,Vladimir-Gordiychuk,2,0.00755,21726,81.98181,26501
3612,vlardn,2,0.00755,21728,81.98936,26501
3613,VobileLiuZhiwu,2,0.00755,21730,81.99691,26501
3614,voiprodrigo,2,0.00755,21732,82.00445,26501
3615,vojtechtuma-imi,2,0.00755,21734,82.01200,26501
3616,Vonter,2,0.00755,21736,82.01955,26501
3617,votientu,2,0.00755,21738,82.02709,26501
3618,vovapabyr,2,0.00755,21740,82.03464,26501
3619,VovkoO,2,0.00755,21742,82.04219,26501
3620,vpl-tbs,2,0.00755,21744,82.04973,26501
3621,vpringault,2,0.00755,21746,82.05728,26501
3622,VP-Samespace,2,0.00755,21748,82.06483,26501
3623,vsoloviov,2,0.00755,21750,82.07237,26501
3624,vyakovlev-hw,2,0.00755,21752,82.07992,26501
3625,walkure,2,0.00755,21754,82.08747,26501
3626,wangeguo,2,0.00755,21756,82.09502,26501
3627,wanghsingmin,2,0.00755,21758,82.10256,26501
3628,wangzhoufei111,2,0.00755,21760,82.11011,26501
3629,wanhua-leo,2,0.00755,21762,82.11766,26501
3630,warrenseine,2,0.00755,21764,82.12520,26501
3631,wcynice,2,0.00755,21766,82.13275,26501
3632,wdsun1008,2,0.00755,21768,82.14030,26501
3633,web7evgheni,2,0.00755,21770,82.14784,26501
3634,weihubeats,2,0.00755,21772,82.15539,26501
3635,wenlong139,2,0.00755,21774,82.16294,26501
3636,WENPIN1,2,0.00755,21776,82.17048,26501
3637,wewark,2,0.00755,21778,82.17803,26501
3638,WhiteEraser,2,0.00755,21780,82.18558,26501
3639,wiktorkisielewski,2,0.00755,21782,82.19312,26501
3640,wilkejo,2,0.00755,21784,82.20067,26501
3641,WillCohenInfotrack,2,0.00755,21786,82.20822,26501
3642,william302,2,0.00755,21788,82.21577,26501
3643,william-best,2,0.00755,21790,82.22331,26501
3644,WilliamLu99,2,0.00755,21792,82.23086,26501
3645,willish,2,0.00755,21794,82.23841,26501
3646,wisaaco,2,0.00755,21796,82.24595,26501
3647,WojciechKuk,2,0.00755,21798,82.25350,26501
3648,wolf1892,2,0.00755,21800,82.26105,26501
3649,wpy-321,2,0.00755,21802,82.26859,26501
3650,wtobis,2,0.00755,21804,82.27614,26501
3651,wymangr,2,0.00755,21806,82.28369,26501
3652,wynterwang,2,0.00755,21808,82.29123,26501
3653,x810366146,2,0.00755,21810,82.29878,26501
3654,xfc,2,0.00755,21812,82.30633,26501
3655,xiangZgnaix,2,0.00755,21814,82.31387,26501
3656,XiaoNuoZ,2,0.00755,21816,82.32142,26501
3657,XiaozhiD-web,2,0.00755,21818,82.32897,26501
3658,xingdong015,2,0.00755,21820,82.33652,26501
3659,xingstudy,2,0.00755,21822,82.34406,26501
3660,xinsir88,2,0.00755,21824,82.35161,26501
3661,XLordalX,2,0.00755,21826,82.35916,26501
3662,x-mass,2,0.00755,21828,82.36670,26501
3663,xodmqjw,2,0.00755,21830,82.37425,26501
3664,xonev,2,0.00755,21832,82.38180,26501
3665,xplg,2,0.00755,21834,82.38934,26501
3666,xuanbo241,2,0.00755,21836,82.39689,26501
3667,xuchenSingle,2,0.00755,21838,82.40444,26501
3668,xuhaitao,2,0.00755,21840,82.41198,26501
3669,xXAvoraXx,2,0.00755,21842,82.41953,26501
3670,xxd819240366,2,0.00755,21844,82.42708,26501
3671,x-Xymos,2,0.00755,21846,82.43463,26501
3672,xyzluo,2,0.00755,21848,82.44217,26501
3673,xzrian,2,0.00755,21850,82.44972,26501
3674,Y7n05h,2,0.00755,21852,82.45727,26501
3675,yanaraha,2,0.00755,21854,82.46481,26501
3676,yanghao605,2,0.00755,21856,82.47236,26501
3677,yanivbh1,2,0.00755,21858,82.47991,26501
3678,yasser-alhawary,2,0.00755,21860,82.48745,26501
3679,yavuz7141,2,0.00755,21862,82.49500,26501
3680,yay14,2,0.00755,21864,82.50255,26501
3681,YCShen1010,2,0.00755,21866,82.51009,26501
3682,ycytt-rs,2,0.00755,21868,82.51764,26501
3683,ydinkin-gcv,2,0.00755,21870,82.52519,26501
3684,yesemenglong,2,0.00755,21872,82.53273,26501
3685,Yessoami,2,0.00755,21874,82.54028,26501
3686,yht1128,2,0.00755,21876,82.54783,26501
3687,Yigenana,2,0.00755,21878,82.55538,26501
3688,yilims,2,0.00755,21880,82.56292,26501
3689,yingxuanwangxuan,2,0.00755,21882,82.57047,26501
3690,yj-ang,2,0.00755,21884,82.57802,26501
3691,ylfbx329,2,0.00755,21886,82.58556,26501
3692,ymengesha,2,0.00755,21888,82.59311,26501
3693,yodaflomaster,2,0.00755,21890,82.60066,26501
3694,yohanb,2,0.00755,21892,82.60820,26501
3695,yoji-kojio,2,0.00755,21894,82.61575,26501
3696,yokishava,2,0.00755,21896,82.62330,26501
3697,yoonjiyong-acorn,2,0.00755,21898,82.63084,26501
3698,yousef-salman,2,0.00755,21900,82.63839,26501
3699,ypoplavs,2,0.00755,21902,82.64594,26501
3700,yuew620,2,0.00755,21904,82.65348,26501
3701,yungjenhung,2,0.00755,21906,82.66103,26501
3702,yutian1224,2,0.00755,21908,82.66858,26501
3703,yuuki0xff,2,0.00755,21910,82.67613,26501
3704,ywsswy,2,0.00755,21912,82.68367,26501
3705,YZPAWE,2,0.00755,21914,82.69122,26501
3706,Z02X,2,0.00755,21916,82.69877,26501
3707,zachauten,2,0.00755,21918,82.70631,26501
3708,zekyabu,2,0.00755,21920,82.71386,26501
3709,zemlyanoy,2,0.00755,21922,82.72141,26501
3710,zenire,2,0.00755,21924,82.72895,26501
3711,zephleggett,2,0.00755,21926,82.73650,26501
3712,zepster,2,0.00755,21928,82.74405,26501
3713,zeritti,2,0.00755,21930,82.75159,26501
3714,zeronewb,2,0.00755,21932,82.75914,26501
3715,zeus2611,2,0.00755,21934,82.76669,26501
3716,zgyn76,2,0.00755,21936,82.77423,26501
3717,zhekazuev,2,0.00755,21938,82.78178,26501
3718,zhenqxuMSFT,2,0.00755,21940,82.78933,26501
3719,Zhu-GF,2,0.00755,21942,82.79688,26501
3720,zlearner1,2,0.00755,21944,82.80442,26501
3721,zmk1173411140,2,0.00755,21946,82.81197,26501
3722,zolovin2022,2,0.00755,21948,82.81952,26501
3723,zpytela,2,0.00755,21950,82.82706,26501
3724,zrice57,2,0.00755,21952,82.83461,26501
3725,zshehov,2,0.00755,21954,82.84216,26501
3726,Zurielevi,2,0.00755,21956,82.84970,26501
3727,zworman-goog,2,0.00755,21958,82.85725,26501
3728,zyfyy,2,0.00755,21960,82.86480,26501
3729,0x26res,1,0.00377,21961,82.86857,26501
3730,15135925147,1,0.00377,21962,82.87234,26501
3731,181860039,1,0.00377,21963,82.87612,26501
3732,18965050,1,0.00377,21964,82.87989,26501
3733,1garo,1,0.00377,21965,82.88366,26501
3734,29swastik,1,0.00377,21966,82.88744,26501
3735,2c9,1,0.00377,21967,82.89121,26501
3736,2tunnels,1,0.00377,21968,82.89499,26501
3737,343GuiltySpark-04,1,0.00377,21969,82.89876,26501
3738,3rgfbrgf,1,0.00377,21970,82.90253,26501
3739,3t8,1,0.00377,21971,82.90631,26501
3740,4wdonny,1,0.00377,21972,82.91008,26501
3741,65a,1,0.00377,21973,82.91385,26501
3742,77-more,1,0.00377,21974,82.91763,26501
3743,8BitSensei,1,0.00377,21975,82.92140,26501
3744,905868332,1,0.00377,21976,82.92517,26501
3745,98christianp,1,0.00377,21977,82.92895,26501
3746,9iang22,1,0.00377,21978,82.93272,26501
3747,9-para,1,0.00377,21979,82.93649,26501
3748,a13xbr0,1,0.00377,21980,82.94027,26501
3749,a16su,1,0.00377,21981,82.94404,26501
3750,a1719928,1,0.00377,21982,82.94781,26501
3751,aakash-sahai,1,0.00377,21983,82.95159,26501
3752,aalemanq,1,0.00377,21984,82.95536,26501
3753,aaron1989041,1,0.00377,21985,82.95913,26501
3754,Aaron-Lei,1,0.00377,21986,82.96291,26501
3755,aaronnad,1,0.00377,21987,82.96668,26501
3756,AaronPhilly,1,0.00377,21988,82.97045,26501
3757,AaronRM,1,0.00377,21989,82.97423,26501
3758,aashishsingh2803,1,0.00377,21990,82.97800,26501
3759,aayadico,1,0.00377,21991,82.98177,26501
3760,aazizk,1,0.00377,21992,82.98555,26501
3761,Abastien1734,1,0.00377,21993,82.98932,26501
3762,abax1,1,0.00377,21994,82.99309,26501
3763,abbbi,1,0.00377,21995,82.99687,26501
3764,abdelaziz009,1,0.00377,21996,83.00064,26501
3765,abderraxim,1,0.00377,21997,83.00441,26501
3766,abdulbello5,1,0.00377,21998,83.00819,26501
3767,A-Beck,1,0.00377,21999,83.01196,26501
3768,AbeOwlu,1,0.00377,22000,83.01574,26501
3769,abhinand5,1,0.00377,22001,83.01951,26501
3770,abhinav1144,1,0.00377,22002,83.02328,26501
3771,abhinavgautam07,1,0.00377,22003,83.02706,26501
3772,abhisek00,1,0.00377,22004,83.03083,26501
3773,Abhishekagrawal1404,1,0.00377,22005,83.03460,26501
3774,abhishekNKamble,1,0.00377,22006,83.03838,26501
3775,abhishekpdelhivery,1,0.00377,22007,83.04215,26501
3776,abhishekS14,1,0.00377,22008,83.04592,26501
3777,absnmohammed,1,0.00377,22009,83.04970,26501
3778,abuxliu,1,0.00377,22010,83.05347,26501
3779,accezar,1,0.00377,22011,83.05724,26501
3780,aceat64,1,0.00377,22012,83.06102,26501
3781,acemaster,1,0.00377,22013,83.06479,26501
3782,achintyak7,1,0.00377,22014,83.06856,26501
3783,achraf2405,1,0.00377,22015,83.07234,26501
3784,aclme,1,0.00377,22016,83.07611,26501
3785,acocuzzo,1,0.00377,22017,83.07988,26501
3786,acola,1,0.00377,22018,83.08366,26501
3787,actualrockstar,1,0.00377,22019,83.08743,26501
3788,ad1mohan,1,0.00377,22020,83.09120,26501
3789,adambiggs,1,0.00377,22021,83.09498,26501
3790,AdamEAnderson,1,0.00377,22022,83.09875,26501
3791,adammike,1,0.00377,22023,83.10252,26501
3792,adarmiento,1,0.00377,22024,83.10630,26501
3793,adcoutinho,1,0.00377,22025,83.11007,26501
3794,addich,1,0.00377,22026,83.11384,26501
3795,adejonghm,1,0.00377,22027,83.11762,26501
3796,Adi-ty,1,0.00377,22028,83.12139,26501
3797,adityadtu5,1,0.00377,22029,83.12517,26501
3798,adityaraibytelearn,1,0.00377,22030,83.12894,26501
3799,adlroux,1,0.00377,22031,83.13271,26501
3800,ADNANFAKHAR4504,1,0.00377,22032,83.13649,26501
3801,adprakash4,1,0.00377,22033,83.14026,26501
3802,AdrianaDJ,1,0.00377,22034,83.14403,26501
3803,adrianhelvik,1,0.00377,22035,83.14781,26501
3804,adrianmarcu18,1,0.00377,22036,83.15158,26501
3805,adrianmeca,1,0.00377,22037,83.15535,26501
3806,Adrianos712,1,0.00377,22038,83.15913,26501
3807,AdrianP873,1,0.00377,22039,83.16290,26501
3808,adsharma,1,0.00377,22040,83.16667,26501
3809,aerphanas,1,0.00377,22041,83.17045,26501
3810,afishler,1,0.00377,22042,83.17422,26501
3811,afloarea,1,0.00377,22043,83.17799,26501
3812,Afsalmc,1,0.00377,22044,83.18177,26501
3813,aftix,1,0.00377,22045,83.18554,26501
3814,agarwalankitnyu,1,0.00377,22046,83.18931,26501
3815,agenslerDNA,1,0.00377,22047,83.19309,26501
3816,agjmills,1,0.00377,22048,83.19686,26501
3817,agtogna-nc,1,0.00377,22049,83.20063,26501
3818,AgustinRamiroDiaz,1,0.00377,22050,83.20441,26501
3819,AGx10k,1,0.00377,22051,83.20818,26501
3820,ahipe101,1,0.00377,22052,83.21195,26501
3821,ahkui,1,0.00377,22053,83.21573,26501
3822,AhmadNaser-me,1,0.00377,22054,83.21950,26501
3823,AhmedMohamedEid,1,0.00377,22055,83.22327,26501
3824,ahs8w,1,0.00377,22056,83.22705,26501
3825,AhsanAtIkea,1,0.00377,22057,83.23082,26501
3826,ahsang,1,0.00377,22058,83.23459,26501
3827,aiellomau,1,0.00377,22059,83.23837,26501
3828,AikedeJongste,1,0.00377,22060,83.24214,26501
3829,Aiky30,1,0.00377,22061,83.24592,26501
3830,a-imran99,1,0.00377,22062,83.24969,26501
3831,Airwarfare,1,0.00377,22063,83.25346,26501
3832,aisenbergmor,1,0.00377,22064,83.25724,26501
3833,aitumik,1,0.00377,22065,83.26101,26501
3834,aiuto-matematica,1,0.00377,22066,83.26478,26501
3835,ai-zelenin,1,0.00377,22067,83.26856,26501
3836,AjaxLeVallee,1,0.00377,22068,83.27233,26501
3837,ajayslele,1,0.00377,22069,83.27610,26501
3838,AJBLATZ,1,0.00377,22070,83.27988,26501
3839,Ajithkumar-Holyappanavar-onkarappa,1,0.00377,22071,83.28365,26501
3840,ajkonkol,1,0.00377,22072,83.28742,26501
3841,ajmaidak,1,0.00377,22073,83.29120,26501
3842,ajmal-yazdani,1,0.00377,22074,83.29497,26501
3843,ajoslin103,1,0.00377,22075,83.29874,26501
3844,Ajpantuso,1,0.00377,22076,83.30252,26501
3845,akashhr,1,0.00377,22077,83.30629,26501
3846,akasyagroup,1,0.00377,22078,83.31006,26501
3847,akgraner,1,0.00377,22079,83.31384,26501
3848,akhilchoudhary2k,1,0.00377,22080,83.31761,26501
3849,akhileshsingh85,1,0.00377,22081,83.32138,26501
3850,AkimitsuTosha,1,0.00377,22082,83.32516,26501
3851,Akinorev,1,0.00377,22083,83.32893,26501
3852,akiryliuk,1,0.00377,22084,83.33270,26501
3853,akiryushin,1,0.00377,22085,83.33648,26501
3854,akrattan,1,0.00377,22086,83.34025,26501
3855,akray50,1,0.00377,22087,83.34402,26501
3856,Akritesom,1,0.00377,22088,83.34780,26501
3857,aks3333,1,0.00377,22089,83.35157,26501
3858,Akshaya-T,1,0.00377,22090,83.35535,26501
3859,akumar074,1,0.00377,22091,83.35912,26501
3860,alaminopu,1,0.00377,22092,83.36289,26501
3861,alanyu9857,1,0.00377,22093,83.36667,26501
3862,alatdev,1,0.00377,22094,83.37044,26501
3863,albertalexandrov,1,0.00377,22095,83.37421,26501
3864,albertoCrego,1,0.00377,22096,83.37799,26501
3865,alejandrotineo,1,0.00377,22097,83.38176,26501
3866,alekspickle,1,0.00377,22098,83.38553,26501
3867,AlexAi27,1,0.00377,22099,83.38931,26501
3868,AlexandarNaydenov,1,0.00377,22100,83.39308,26501
3869,alexandear,1,0.00377,22101,83.39685,26501
3870,Alexander-ac,1,0.00377,22102,83.40063,26501
3871,alexanderstephan,1,0.00377,22103,83.40440,26501
3872,alexandervpetrov,1,0.00377,22104,83.40817,26501
3873,AlexanderZon,1,0.00377,22105,83.41195,26501
3874,AlexandrBoltris,1,0.00377,22106,83.41572,26501
3875,alexandre-k,1,0.00377,22107,83.41949,26501
3876,alexandrepesant,1,0.00377,22108,83.42327,26501
3877,alexandru-stoica,1,0.00377,22109,83.42704,26501
3878,alexbescond,1,0.00377,22110,83.43081,26501
3879,alexcogojocaru,1,0.00377,22111,83.43459,26501
3880,alex-from-intuita,1,0.00377,22112,83.43836,26501
3881,Alex-Garg,1,0.00377,22113,83.44213,26501
3882,AlexGatz,1,0.00377,22114,83.44591,26501
3883,alexlep,1,0.00377,22115,83.44968,26501
3884,alexqbo,1,0.00377,22116,83.45345,26501
3885,alexsuninsth,1,0.00377,22117,83.45723,26501
3886,alextadams88,1,0.00377,22118,83.46100,26501
3887,alexvonstein,1,0.00377,22119,83.46477,26501
3888,AlfadilTabar,1,0.00377,22120,83.46855,26501
3889,alfeg,1,0.00377,22121,83.47232,26501
3890,alfredocambera,1,0.00377,22122,83.47610,26501
3891,alfredosola,1,0.00377,22123,83.47987,26501
3892,Ali0600,1,0.00377,22124,83.48364,26501
3893,Ali-Activity,1,0.00377,22125,83.48742,26501
3894,aliaksei-babuk,1,0.00377,22126,83.49119,26501
3895,ali-idrizi,1,0.00377,22127,83.49496,26501
3896,Alisha-R,1,0.00377,22128,83.49874,26501
3897,Alivers,1,0.00377,22129,83.50251,26501
3898,alkurbatov,1,0.00377,22130,83.50628,26501
3899,allebone,1,0.00377,22131,83.51006,26501
3900,allfro,1,0.00377,22132,83.51383,26501
3901,AllieEvers,1,0.00377,22133,83.51760,26501
3902,allyn-bottorff,1,0.00377,22134,83.52138,26501
3903,alnjieg,1,0.00377,22135,83.52515,26501
3904,AloisKraus,1,0.00377,22136,83.52892,26501
3905,alonch,1,0.00377,22137,83.53270,26501
3906,alonkrispin43,1,0.00377,22138,83.53647,26501
3907,alpeshbhavsar,1,0.00377,22139,83.54024,26501
3908,alsobrsp,1,0.00377,22140,83.54402,26501
3909,altosys,1,0.00377,22141,83.54779,26501
3910,alves-luis,1,0.00377,22142,83.55156,26501
3911,alxric,1,0.00377,22143,83.55534,26501
3912,alyubimof,1,0.00377,22144,83.55911,26501
3913,alzinfo,1,0.00377,22145,83.56288,26501
3914,AM1988,1,0.00377,22146,83.56666,26501
3915,aman21391,1,0.00377,22147,83.57043,26501
3916,amanBhargava05,1,0.00377,22148,83.57420,26501
3917,amanraj-iit,1,0.00377,22149,83.57798,26501
3918,amard33p,1,0.00377,22150,83.58175,26501
3919,amar-g72,1,0.00377,22151,83.58553,26501
3920,amateope,1,0.00377,22152,83.58930,26501
3921,amavrogiannis,1,0.00377,22153,83.59307,26501
3922,Ambassador4ik,1,0.00377,22154,83.59685,26501
3923,amber-h,1,0.00377,22155,83.60062,26501
3924,Ameer-clk,1,0.00377,22156,83.60439,26501
3925,ameyer117,1,0.00377,22157,83.60817,26501
3926,amir2227,1,0.00377,22158,83.61194,26501
3927,AmirAliSoftwareEngineer,1,0.00377,22159,83.61571,26501
3928,amit88265,1,0.00377,22160,83.61949,26501
3929,aMohammadEmami,1,0.00377,22161,83.62326,26501
3930,amolsr,1,0.00377,22162,83.62703,26501
3931,Amrish-Sharma,1,0.00377,22163,83.63081,26501
3932,amscins,1,0.00377,22164,83.63458,26501
3933,amtdevops,1,0.00377,22165,83.63835,26501
3934,ana-cozma,1,0.00377,22166,83.64213,26501
3935,analuramalho,1,0.00377,22167,83.64590,26501
3936,Anand25021998,1,0.00377,22168,83.64967,26501
3937,anandyashika,1,0.00377,22169,83.65345,26501
3938,anas-zurkiyeh-sp,1,0.00377,22170,83.65722,26501
3939,anchlovi,1,0.00377,22171,83.66099,26501
3940,ancyrweb,1,0.00377,22172,83.66477,26501
3941,andaag,1,0.00377,22173,83.66854,26501
3942,anderslundholm,1,0.00377,22174,83.67231,26501
3943,andi0b,1,0.00377,22175,83.67609,26501
3944,andjos,1,0.00377,22176,83.67986,26501
3945,andreapulvirenti,1,0.00377,22177,83.68363,26501
3946,andreclaro,1,0.00377,22178,83.68741,26501
3947,andreeamun,1,0.00377,22179,83.69118,26501
3948,andreeee,1,0.00377,22180,83.69495,26501
3949,andrei693,1,0.00377,22181,83.69873,26501
3950,AndreiBiarzhynski,1,0.00377,22182,83.70250,26501
3951,AndreiDoroftei,1,0.00377,22183,83.70628,26501
3952,andreluizsgf,1,0.00377,22184,83.71005,26501
3953,andre-meneses-fivestars,1,0.00377,22185,83.71382,26501
3954,andremetzen,1,0.00377,22186,83.71760,26501
3955,andremissaglia,1,0.00377,22187,83.72137,26501
3956,andrescolodrero,1,0.00377,22188,83.72514,26501
3957,andreu7d,1,0.00377,22189,83.72892,26501
3958,andrew1044,1,0.00377,22190,83.73269,26501
3959,andrew-aiken,1,0.00377,22191,83.73646,26501
3960,andrewa-stripe,1,0.00377,22192,83.74024,26501
3961,andrew-goldie,1,0.00377,22193,83.74401,26501
3962,andrewhalle,1,0.00377,22194,83.74778,26501
3963,andrewperkins,1,0.00377,22195,83.75156,26501
3964,andreyklumchyk,1,0.00377,22196,83.75533,26501
3965,andrimuhyidin,1,0.00377,22197,83.75910,26501
3966,andykcfung,1,0.00377,22198,83.76288,26501
3967,andymartin-sch,1,0.00377,22199,83.76665,26501
3968,AndySardina,1,0.00377,22200,83.77042,26501
3969,aneja-arun1,1,0.00377,22201,83.77420,26501
3970,AngeloFrangione,1,0.00377,22202,83.77797,26501
3971,anhaehne,1,0.00377,22203,83.78174,26501
3972,anhaogege,1,0.00377,22204,83.78552,26501
3973,anhqqt,1,0.00377,22205,83.78929,26501
3974,aniketdogra07,1,0.00377,22206,83.79306,26501
3975,anilerencelik,1,0.00377,22207,83.79684,26501
3976,aniljaiswal,1,0.00377,22208,83.80061,26501
3977,Anil-Raja,1,0.00377,22209,83.80438,26501
3978,AnishLushte07,1,0.00377,22210,83.80816,26501
3979,anismajd,1,0.00377,22211,83.81193,26501
3980,anjith-perfagents,1,0.00377,22212,83.81571,26501
3981,ankianshu3003,1,0.00377,22213,83.81948,26501
3982,ankiiitraj,1,0.00377,22214,83.82325,26501
3983,AnkitAdarsh,1,0.00377,22215,83.82703,26501
3984,ankit-db,1,0.00377,22216,83.83080,26501
3985,anomam,1,0.00377,22217,83.83457,26501
3986,anon8675309,1,0.00377,22218,83.83835,26501
3987,anoopadvaitha,1,0.00377,22219,83.84212,26501
3988,anoopka1739,1,0.00377,22220,83.84589,26501
3989,anoopmun,1,0.00377,22221,83.84967,26501
3990,anoxape,1,0.00377,22222,83.85344,26501
3991,AnqiPang,1,0.00377,22223,83.85721,26501
3992,anshjain18,1,0.00377,22224,83.86099,26501
3993,Anshu-Garg,1,0.00377,22225,83.86476,26501
3994,anteph,1,0.00377,22226,83.86853,26501
3995,anthonyptetlow,1,0.00377,22227,83.87231,26501
3996,antoineDievDecath,1,0.00377,22228,83.87608,26501
3997,anton3332,1,0.00377,22229,83.87985,26501
3998,antongisli,1,0.00377,22230,83.88363,26501
3999,antoniodiazroman,1,0.00377,22231,83.88740,26501
4000,AntoniosBarotsis,1,0.00377,22232,83.89117,26501
4001,antonio-tg,1,0.00377,22233,83.89495,26501
4002,AntonPates,1,0.00377,22234,83.89872,26501
4003,AntonSamojlow,1,0.00377,22235,83.90249,26501
4004,anuj-sharma-ibm,1,0.00377,22236,83.90627,26501
4005,anvsaxen,1,0.00377,22237,83.91004,26501
4006,aoggz,1,0.00377,22238,83.91381,26501
4007,apal60,1,0.00377,22239,83.91759,26501
4008,apanasevich,1,0.00377,22240,83.92136,26501
4009,ap-kulkarni,1,0.00377,22241,83.92513,26501
4010,apollo1130,1,0.00377,22242,83.92891,26501
4011,apontes-pagerduty,1,0.00377,22243,83.93268,26501
4012,apoorvam1,1,0.00377,22244,83.93646,26501
4013,apoorvamk,1,0.00377,22245,83.94023,26501
4014,appleearth008,1,0.00377,22246,83.94400,26501
4015,apresti12,1,0.00377,22247,83.94778,26501
4016,arajguruEST,1,0.00377,22248,83.95155,26501
4017,aran,1,0.00377,22249,83.95532,26501
4018,Archanium,1,0.00377,22250,83.95910,26501
4019,Archisman-Mridha,1,0.00377,22251,83.96287,26501
4020,archupriya3,1,0.00377,22252,83.96664,26501
4021,aRc-rAy,1,0.00377,22253,83.97042,26501
4022,ARC-syn,1,0.00377,22254,83.97419,26501
4023,arie-kachler,1,0.00377,22255,83.97796,26501
4024,arilou,1,0.00377,22256,83.98174,26501
4025,arjun-beathi,1,0.00377,22257,83.98551,26501
4026,Arjun-D7,1,0.00377,22258,83.98928,26501
4027,arjunrao0687,1,0.00377,22259,83.99306,26501
4028,armandocollazo-tomtom,1,0.00377,22260,83.99683,26501
4029,arnab-r3,1,0.00377,22261,84.00060,26501
4030,arnoreyvar,1,0.00377,22262,84.00438,26501
4031,aroommen,1,0.00377,22263,84.00815,26501
4032,arslan-ahmad,1,0.00377,22264,84.01192,26501
4033,ArtemKaba,1,0.00377,22265,84.01570,26501
4034,artemkozlenkovvzug,1,0.00377,22266,84.01947,26501
4035,ArthurHNL,1,0.00377,22267,84.02324,26501
4036,ArthurMVilela,1,0.00377,22268,84.02702,26501
4037,arthurzam,1,0.00377,22269,84.03079,26501
4038,arusahni,1,0.00377,22270,84.03456,26501
4039,Arvindh-Mojo,1,0.00377,22271,84.03834,26501
4040,AryanMankame,1,0.00377,22272,84.04211,26501
4041,asadakbar,1,0.00377,22273,84.04589,26501
4042,asador,1,0.00377,22274,84.04966,26501
4043,asaub,1,0.00377,22275,84.05343,26501
4044,aserraric,1,0.00377,22276,84.05721,26501
4045,AsfaMumtaz,1,0.00377,22277,84.06098,26501
4046,ash271182,1,0.00377,22278,84.06475,26501
4047,AshfaqMH,1,0.00377,22279,84.06853,26501
4048,ashokat258,1,0.00377,22280,84.07230,26501
4049,ashtonicci,1,0.00377,22281,84.07607,26501
4050,ashvinsharma,1,0.00377,22282,84.07985,26501
4051,Asilent,1,0.00377,22283,84.08362,26501
4052,asimkt,1,0.00377,22284,84.08739,26501
4053,asitha23,1,0.00377,22285,84.09117,26501
4054,asongent,1,0.00377,22286,84.09494,26501
4055,asta1992,1,0.00377,22287,84.09871,26501
4056,astralko,1,0.00377,22288,84.10249,26501
4057,asurowka,1,0.00377,22289,84.10626,26501
4058,asuwini,1,0.00377,22290,84.11003,26501
4059,atcvetkov,1,0.00377,22291,84.11381,26501
4060,atedsimple,1,0.00377,22292,84.11758,26501
4061,Atemu,1,0.00377,22293,84.12135,26501
4062,atenekom,1,0.00377,22294,84.12513,26501
4063,Atharshoyeb,1,0.00377,22295,84.12890,26501
4064,atherfawaz,1,0.00377,22296,84.13267,26501
4065,atipugin,1,0.00377,22297,84.13645,26501
4066,atlanboa,1,0.00377,22298,84.14022,26501
4067,Atrox,1,0.00377,22299,84.14399,26501
4068,atsalolikhin-spokeo,1,0.00377,22300,84.14777,26501
4069,AttackOnNewbie,1,0.00377,22301,84.15154,26501
4070,attila-balint-kul,1,0.00377,22302,84.15531,26501
4071,audwl,1,0.00377,22303,84.15909,26501
4072,augustovictor,1,0.00377,22304,84.16286,26501
4073,AurimasNav,1,0.00377,22305,84.16664,26501
4074,auroraqin,1,0.00377,22306,84.17041,26501
4075,avalsa,1,0.00377,22307,84.17418,26501
4076,aventi-lasith,1,0.00377,22308,84.17796,26501
4077,avershave,1,0.00377,22309,84.18173,26501
4078,avingoyal,1,0.00377,22310,84.18550,26501
4079,avinilcodes,1,0.00377,22311,84.18928,26501
4080,awideweb,1,0.00377,22312,84.19305,26501
4081,awmackowiak,1,0.00377,22313,84.19682,26501
4082,awspandian,1,0.00377,22314,84.20060,26501
4083,axljoker03,1,0.00377,22315,84.20437,26501
4084,ayrat555,1,0.00377,22316,84.20814,26501
4085,aytemuryakup,1,0.00377,22317,84.21192,26501
4086,ayushpadia,1,0.00377,22318,84.21569,26501
4087,Ayyan-droid,1,0.00377,22319,84.21946,26501
4088,azcu-publishing,1,0.00377,22320,84.22324,26501
4089,azhiltsov,1,0.00377,22321,84.22701,26501
4090,AzimWarsii,1,0.00377,22322,84.23078,26501
4091,azmansalleh,1,0.00377,22323,84.23456,26501
4092,b0n0r,1,0.00377,22324,84.23833,26501
4093,b34rd-tek,1,0.00377,22325,84.24210,26501
4094,bachue,1,0.00377,22326,84.24588,26501
4095,badkaktus,1,0.00377,22327,84.24965,26501
4096,badP0inter,1,0.00377,22328,84.25342,26501
4097,badrdouah,1,0.00377,22329,84.25720,26501
4098,baizhenyu,1,0.00377,22330,84.26097,26501
4099,balavellingiri,1,0.00377,22331,84.26474,26501
4100,Baldinof,1,0.00377,22332,84.26852,26501
4101,balebomm,1,0.00377,22333,84.27229,26501
4102,BalticBytes,1,0.00377,22334,84.27607,26501
4103,balzhik95,1,0.00377,22335,84.27984,26501
4104,ban4e,1,0.00377,22336,84.28361,26501
4105,bandrefilipe,1,0.00377,22337,84.28739,26501
4106,Baody12138,1,0.00377,22338,84.29116,26501
4107,barbarosh,1,0.00377,22339,84.29493,26501
4108,BarbarossaTM,1,0.00377,22340,84.29871,26501
4109,barber-k,1,0.00377,22341,84.30248,26501
4110,barchw,1,0.00377,22342,84.30625,26501
4111,barisvelioglu,1,0.00377,22343,84.31003,26501
4112,barronandersonmongo,1,0.00377,22344,84.31380,26501
4113,barrycommins,1,0.00377,22345,84.31757,26501
4114,bartengine27,1,0.00377,22346,84.32135,26501
4115,bartleyg,1,0.00377,22347,84.32512,26501
4116,bartoszchajek,1,0.00377,22348,84.32889,26501
4117,barunavo,1,0.00377,22349,84.33267,26501
4118,barzog,1,0.00377,22350,84.33644,26501
4119,basant774,1,0.00377,22351,84.34021,26501
4120,basil1120,1,0.00377,22352,84.34399,26501
4121,basilvg-eGov,1,0.00377,22353,84.34776,26501
4122,baskamic,1,0.00377,22354,84.35153,26501
4123,BassMonkey,1,0.00377,22355,84.35531,26501
4124,bastosrafael,1,0.00377,22356,84.35908,26501
4125,bbalakriz,1,0.00377,22357,84.36285,26501
4126,BBB-Angelo,1,0.00377,22358,84.36663,26501
4127,bbergstrom,1,0.00377,22359,84.37040,26501
4128,BC89,1,0.00377,22360,84.37417,26501
4129,bcessa,1,0.00377,22361,84.37795,26501
4130,bdalton,1,0.00377,22362,84.38172,26501
4131,bdparrish,1,0.00377,22363,84.38549,26501
4132,Beatriz813,1,0.00377,22364,84.38927,26501
4133,behrooz,1,0.00377,22365,84.39304,26501
4134,beinghumane,1,0.00377,22366,84.39682,26501
4135,bekker,1,0.00377,22367,84.40059,26501
4136,ben-codner-rs,1,0.00377,22368,84.40436,26501
4137,BeneStem,1,0.00377,22369,84.40814,26501
4138,benfielden-onx,1,0.00377,22370,84.41191,26501
4139,Benjaminvdv,1,0.00377,22371,84.41568,26501
4140,benjdewan,1,0.00377,22372,84.41946,26501
4141,benma,1,0.00377,22373,84.42323,26501
4142,BennyAfriat,1,0.00377,22374,84.42700,26501
4143,benonich,1,0.00377,22375,84.43078,26501
4144,benydc,1,0.00377,22376,84.43455,26501
4145,benzaidfoued,1,0.00377,22377,84.43832,26501
4146,BerBai,1,0.00377,22378,84.44210,26501
4147,bercob,1,0.00377,22379,84.44587,26501
4148,bernardogeneroso,1,0.00377,22380,84.44964,26501
4149,besacierc,1,0.00377,22381,84.45342,26501
4150,besanek,1,0.00377,22382,84.45719,26501
4151,bfahm,1,0.00377,22383,84.46096,26501
4152,bfouts-osaro,1,0.00377,22384,84.46474,26501
4153,bgronek,1,0.00377,22385,84.46851,26501
4154,Bharat4317,1,0.00377,22386,84.47228,26501
4155,bhat-ganesh,1,0.00377,22387,84.47606,26501
4156,bhati-github,1,0.00377,22388,84.47983,26501
4157,bhattanil,1,0.00377,22389,84.48360,26501
4158,Bhautik0110,1,0.00377,22390,84.48738,26501
4159,Bhavana-211,1,0.00377,22391,84.49115,26501
4160,bhavikbhavsar,1,0.00377,22392,84.49492,26501
4161,BhimraoPatil,1,0.00377,22393,84.49870,26501
4162,bhuwan87,1,0.00377,22394,84.50247,26501
4163,Biagio-Dipalma,1,0.00377,22395,84.50625,26501
4164,bibic-vegait,1,0.00377,22396,84.51002,26501
4165,bigbirdxixi,1,0.00377,22397,84.51379,26501
4166,bigjordon,1,0.00377,22398,84.51757,26501
4167,bigpear0201,1,0.00377,22399,84.52134,26501
4168,bigunyak,1,0.00377,22400,84.52511,26501
4169,BijenderRana,1,0.00377,22401,84.52889,26501
4170,bilcus,1,0.00377,22402,84.53266,26501
4171,billyxue,1,0.00377,22403,84.53643,26501
4172,Bimalnp4me,1,0.00377,22404,84.54021,26501
4173,bingws,1,0.00377,22405,84.54398,26501
4174,binshi-bing,1,0.00377,22406,84.54775,26501
4175,BioQwer,1,0.00377,22407,84.55153,26501
4176,BitTheByte,1,0.00377,22408,84.55530,26501
4177,BJDK,1,0.00377,22409,84.55907,26501
4178,Blaimi,1,0.00377,22410,84.56285,26501
4179,BlastillROID,1,0.00377,22411,84.56662,26501
4180,blezoray,1,0.00377,22412,84.57039,26501
4181,blogle,1,0.00377,22413,84.57417,26501
4182,bluek1te,1,0.00377,22414,84.57794,26501
4183,bluespiderit,1,0.00377,22415,84.58171,26501
4184,blufor,1,0.00377,22416,84.58549,26501
4185,B-Marine,1,0.00377,22417,84.58926,26501
4186,bnbrijesh,1,0.00377,22418,84.59303,26501
4187,BND10706,1,0.00377,22419,84.59681,26501
4188,bob-bbb,1,0.00377,22420,84.60058,26501
4189,Bobo1239,1,0.00377,22421,84.60435,26501
4190,bobsira,1,0.00377,22422,84.60813,26501
4191,bociankruk,1,0.00377,22423,84.61190,26501
4192,bogdanpetrovsky,1,0.00377,22424,84.61567,26501
4193,BOKYUNGGG,1,0.00377,22425,84.61945,26501
4194,bombomla,1,0.00377,22426,84.62322,26501
4195,boncri,1,0.00377,22427,84.62700,26501
4196,boomjuice,1,0.00377,22428,84.63077,26501
4197,bop0hz,1,0.00377,22429,84.63454,26501
4198,borelsaffo,1,0.00377,22430,84.63832,26501
4199,boris154,1,0.00377,22431,84.64209,26501
4200,Borosan,1,0.00377,22432,84.64586,26501
4201,borqq,1,0.00377,22433,84.64964,26501
4202,Bota5ky,1,0.00377,22434,84.65341,26501
4203,Botje,1,0.00377,22435,84.65718,26501
4204,boturkin,1,0.00377,22436,84.66096,26501
4205,BouzayenMohamed,1,0.00377,22437,84.66473,26501
4206,Boya-Na,1,0.00377,22438,84.66850,26501
4207,bparmar-splunk,1,0.00377,22439,84.67228,26501
4208,bpatel85,1,0.00377,22440,84.67605,26501
4209,bradleydamato,1,0.00377,22441,84.67982,26501
4210,brampling,1,0.00377,22442,84.68360,26501
4211,BrandonBocheng,1,0.00377,22443,84.68737,26501
4212,brandonmenc,1,0.00377,22444,84.69114,26501
4213,brandon-segal,1,0.00377,22445,84.69492,26501
4214,brandtkilian,1,0.00377,22446,84.69869,26501
4215,Brar,1,0.00377,22447,84.70246,26501
4216,brconnell4,1,0.00377,22448,84.70624,26501
4217,BredSt,1,0.00377,22449,84.71001,26501
4218,BrennanAyers,1,0.00377,22450,84.71378,26501
4219,Brennwert,1,0.00377,22451,84.71756,26501
4220,brentgroves,1,0.00377,22452,84.72133,26501
4221,brett-au,1,0.00377,22453,84.72510,26501
4222,brettinternet,1,0.00377,22454,84.72888,26501
4223,brett-vendia,1,0.00377,22455,84.73265,26501
4224,brianV,1,0.00377,22456,84.73643,26501
4225,brillience,1,0.00377,22457,84.74020,26501
4226,BrivinTech,1,0.00377,22458,84.74397,26501
4227,brsamb9,1,0.00377,22459,84.74775,26501
4228,brunobottazzini,1,0.00377,22460,84.75152,26501
4229,brunokino,1,0.00377,22461,84.75529,26501
4230,brunoscota,1,0.00377,22462,84.75907,26501
4231,bryanSME,1,0.00377,22463,84.76284,26501
4232,bshaun8,1,0.00377,22464,84.76661,26501
4233,btruong66,1,0.00377,22465,84.77039,26501
4234,buckleyGI,1,0.00377,22466,84.77416,26501
4235,buffalo1024,1,0.00377,22467,84.77793,26501
4236,buffstyles,1,0.00377,22468,84.78171,26501
4237,bulletinmybeard,1,0.00377,22469,84.78548,26501
4238,bunnybilou,1,0.00377,22470,84.78925,26501
4239,burhanuguz,1,0.00377,22471,84.79303,26501
4240,bvpb,1,0.00377,22472,84.79680,26501
4241,bwagner3slb,1,0.00377,22473,84.80057,26501
4242,byashimov,1,0.00377,22474,84.80435,26501
4243,byllyfish,1,0.00377,22475,84.80812,26501
4244,byt3h3ad,1,0.00377,22476,84.81189,26501
4245,byt3-m3,1,0.00377,22477,84.81567,26501
4246,ByteFlyCoding,1,0.00377,22478,84.81944,26501
4247,bzurek1,1,0.00377,22479,84.82321,26501
4248,c1ay,1,0.00377,22480,84.82699,26501
4249,c202c,1,0.00377,22481,84.83076,26501
4250,ca8IiN4oow,1,0.00377,22482,84.83453,26501
4251,caetanobca,1,0.00377,22483,84.83831,26501
4252,CaffeineDaemon,1,0.00377,22484,84.84208,26501
4253,cahn3,1,0.00377,22485,84.84585,26501
4254,caichenghao1991,1,0.00377,22486,84.84963,26501
4255,caige-kelly,1,0.00377,22487,84.85340,26501
4256,caimaoy,1,0.00377,22488,84.85718,26501
4257,calebebrim,1,0.00377,22489,84.86095,26501
4258,CalinFlorescu,1,0.00377,22490,84.86472,26501
4259,calipee,1,0.00377,22491,84.86850,26501
4260,callen-raft,1,0.00377,22492,84.87227,26501
4261,calmzhu,1,0.00377,22493,84.87604,26501
4262,calumrees99,1,0.00377,22494,84.87982,26501
4263,camposer,1,0.00377,22495,84.88359,26501
4264,CanisCoder,1,0.00377,22496,84.88736,26501
4265,captainstdin,1,0.00377,22497,84.89114,26501
4266,captify-sjunaid,1,0.00377,22498,84.89491,26501
4267,caraways,1,0.00377,22499,84.89868,26501
4268,carhartl,1,0.00377,22500,84.90246,26501
4269,CarlosReynoso12,1,0.00377,22501,84.90623,26501
4270,carun,1,0.00377,22502,84.91000,26501
4271,catkins-dmg,1,0.00377,22503,84.91378,26501
4272,causton81,1,0.00377,22504,84.91755,26501
4273,cavator,1,0.00377,22505,84.92132,26501
4274,cawwot,1,0.00377,22506,84.92510,26501
4275,cblegare,1,0.00377,22507,84.92887,26501
4276,ccaoseeyoutomorrow,1,0.00377,22508,84.93264,26501
4277,CCC598,1,0.00377,22509,84.93642,26501
4278,ccdaniele,1,0.00377,22510,84.94019,26501
4279,cchwasd,1,0.00377,22511,84.94396,26501
4280,ccjette-logmein,1,0.00377,22512,84.94774,26501
4281,ccmaxcc,1,0.00377,22513,84.95151,26501
4282,ccoager,1,0.00377,22514,84.95528,26501
4283,cctomato,1,0.00377,22515,84.95906,26501
4284,cdeeran,1,0.00377,22516,84.96283,26501
4285,cdutten,1,0.00377,22517,84.96661,26501
4286,CedricGabette,1,0.00377,22518,84.97038,26501
4287,cedvict,1,0.00377,22519,84.97415,26501
4288,ceejimus,1,0.00377,22520,84.97793,26501
4289,cekeren,1,0.00377,22521,84.98170,26501
4290,celery-xqq,1,0.00377,22522,84.98547,26501
4291,celeskyking,1,0.00377,22523,84.98925,26501
4292,Celso-19,1,0.00377,22524,84.99302,26501
4293,cesarbmx,1,0.00377,22525,84.99679,26501
4294,cespedes,1,0.00377,22526,85.00057,26501
4295,cezmunsta,1,0.00377,22527,85.00434,26501
4296,cf532088799,1,0.00377,22528,85.00811,26501
4297,cFire,1,0.00377,22529,85.01189,26501
4298,cgallay,1,0.00377,22530,85.01566,26501
4299,cguedel,1,0.00377,22531,85.01943,26501
4300,chaitanyakusumba,1,0.00377,22532,85.02321,26501
4301,chalie86,1,0.00377,22533,85.02698,26501
4302,chamakov,1,0.00377,22534,85.03075,26501
4303,chanchn,1,0.00377,22535,85.03453,26501
4304,chandakanant,1,0.00377,22536,85.03830,26501
4305,chandankumar1307,1,0.00377,22537,85.04207,26501
4306,changemyminds,1,0.00377,22538,85.04585,26501
4307,changhoi,1,0.00377,22539,85.04962,26501
4308,chaobei77,1,0.00377,22540,85.05339,26501
4309,char8,1,0.00377,22541,85.05717,26501
4310,Charlesdjy,1,0.00377,22542,85.06094,26501
4311,charlychiu,1,0.00377,22543,85.06471,26501
4312,CharlyPierce,1,0.00377,22544,85.06849,26501
4313,chatchai-outreach,1,0.00377,22545,85.07226,26501
4314,chaudharisuresh997,1,0.00377,22546,85.07603,26501
4315,ChauhanKrunal,1,0.00377,22547,85.07981,26501
4316,ChayanSD,1,0.00377,22548,85.08358,26501
4317,chenhaoenen,1,0.00377,22549,85.08736,26501
4318,chenlcacentury,1,0.00377,22550,85.09113,26501
4319,chessl,1,0.00377,22551,85.09490,26501
4320,chiheb08,1,0.00377,22552,85.09868,26501
4321,chilikbayevabay,1,0.00377,22553,85.10245,26501
4322,ChimbuChinnadurai,1,0.00377,22554,85.10622,26501
4323,chimons,1,0.00377,22555,85.11000,26501
4324,chiptus,1,0.00377,22556,85.11377,26501
4325,chkp-alexgl,1,0.00377,22557,85.11754,26501
4326,choerl-sys11,1,0.00377,22558,85.12132,26501
4327,choyuansu,1,0.00377,22559,85.12509,26501
4328,chr0mag,1,0.00377,22560,85.12886,26501
4329,chrisarmand,1,0.00377,22561,85.13264,26501
4330,chris-brown,1,0.00377,22562,85.13641,26501
4331,chrisditrani,1,0.00377,22563,85.14018,26501
4332,chrislinan,1,0.00377,22564,85.14396,26501
4333,chrismuellner,1,0.00377,22565,85.14773,26501
4334,christf,1,0.00377,22566,85.15150,26501
4335,christian-englert-etecture,1,0.00377,22567,85.15528,26501
4336,christianwolfcodesorcerer,1,0.00377,22568,85.15905,26501
4337,ChristianZaccaria,1,0.00377,22569,85.16282,26501
4338,christieyang,1,0.00377,22570,85.16660,26501
4339,christophergertz,1,0.00377,22571,85.17037,26501
4340,christopherglennreed,1,0.00377,22572,85.17414,26501
4341,chrsmeca,1,0.00377,22573,85.17792,26501
4342,chuck47dx,1,0.00377,22574,85.18169,26501
4343,chudesno,1,0.00377,22575,85.18546,26501
4344,chunli-lab,1,0.00377,22576,85.18924,26501
4345,chyeyun,1,0.00377,22577,85.19301,26501
4346,chzhuo,1,0.00377,22578,85.19679,26501
4347,ciacono,1,0.00377,22579,85.20056,26501
4348,ciantfv456,1,0.00377,22580,85.20433,26501
4349,cicada-chen,1,0.00377,22581,85.20811,26501
4350,cisionmarkwalls,1,0.00377,22582,85.21188,26501
4351,cjjeakle,1,0.00377,22583,85.21565,26501
4352,cjp1016,1,0.00377,22584,85.21943,26501
4353,cjtim,1,0.00377,22585,85.22320,26501
4354,ckchessmaster,1,0.00377,22586,85.22697,26501
4355,ckfahad,1,0.00377,22587,85.23075,26501
4356,ckpklos,1,0.00377,22588,85.23452,26501
4357,claviola,1,0.00377,22589,85.23829,26501
4358,claytonig,1,0.00377,22590,85.24207,26501
4359,clemenskol,1,0.00377,22591,85.24584,26501
4360,Clomonitor10,1,0.00377,22592,85.24961,26501
4361,cloudier1337,1,0.00377,22593,85.25339,26501
4362,cmagk,1,0.00377,22594,85.25716,26501
4363,cmaguluri1305,1,0.00377,22595,85.26093,26501
4364,cmssliangxin,1,0.00377,22596,85.26471,26501
4365,CNCF-Bot2,1,0.00377,22597,85.26848,26501
4366,CoatedMoose,1,0.00377,22598,85.27225,26501
4367,cobir,1,0.00377,22599,85.27603,26501
4368,codeamongus,1,0.00377,22600,85.27980,26501
4369,coder-kevin-1985,1,0.00377,22601,85.28357,26501
4370,codeRuslan,1,0.00377,22602,85.28735,26501
4371,codyborders,1,0.00377,22603,85.29112,26501
4372,codyhoag,1,0.00377,22604,85.29489,26501
4373,cognitedata,1,0.00377,22605,85.29867,26501
4374,coiby,1,0.00377,22606,85.30244,26501
4375,colans,1,0.00377,22607,85.30621,26501
4376,colossus-creator,1,0.00377,22608,85.30999,26501
4377,compudaster,1,0.00377,22609,85.31376,26501
4378,Compulsed,1,0.00377,22610,85.31754,26501
4379,conbrad,1,0.00377,22611,85.32131,26501
4380,congziqi77,1,0.00377,22612,85.32508,26501
4381,conner-bissell,1,0.00377,22613,85.32886,26501
4382,connor-bugler,1,0.00377,22614,85.33263,26501
4383,ContainerCheckpoint,1,0.00377,22615,85.33640,26501
4384,conways-glider,1,0.00377,22616,85.34018,26501
4385,cooper190113,1,0.00377,22617,85.34395,26501
4386,cornhubius,1,0.00377,22618,85.34772,26501
4387,CorwinNewall,1,0.00377,22619,85.35150,26501
4388,cosmojg,1,0.00377,22620,85.35527,26501
4389,coultat,1,0.00377,22621,85.35904,26501
4390,coverthesea,1,0.00377,22622,85.36282,26501
4391,coylecullen,1,0.00377,22623,85.36659,26501
4392,cpetestewart,1,0.00377,22624,85.37036,26501
4393,Cquad,1,0.00377,22625,85.37414,26501
4394,craigsdennis,1,0.00377,22626,85.37791,26501
4395,crain-cn,1,0.00377,22627,85.38168,26501
4396,Crazy-Hopper,1,0.00377,22628,85.38546,26501
4397,crdo0923,1,0.00377,22629,85.38923,26501
4398,cresvi,1,0.00377,22630,85.39300,26501
4399,cristina-lopez,1,0.00377,22631,85.39678,26501
4400,cronjevh,1,0.00377,22632,85.40055,26501
4401,crt0r,1,0.00377,22633,85.40432,26501
4402,crypticDAGGER,1,0.00377,22634,85.40810,26501
4403,cryptosquirrels,1,0.00377,22635,85.41187,26501
4404,csaltos,1,0.00377,22636,85.41564,26501
4405,csnelsonchu,1,0.00377,22637,85.41942,26501
4406,csthomas1,1,0.00377,22638,85.42319,26501
4407,cstuart-sqsp,1,0.00377,22639,85.42697,26501
4408,CSUDaXiang,1,0.00377,22640,85.43074,26501
4409,ctheodoropoulos,1,0.00377,22641,85.43451,26501
4410,cthu1hoo,1,0.00377,22642,85.43829,26501
4411,ctleo,1,0.00377,22643,85.44206,26501
4412,ctorresunimag95,1,0.00377,22644,85.44583,26501
4413,CTZHA,1,0.00377,22645,85.44961,26501
4414,cuongquach,1,0.00377,22646,85.45338,26501
4415,Cupprum,1,0.00377,22647,85.45715,26501
4416,cupsos,1,0.00377,22648,85.46093,26501
4417,customer101,1,0.00377,22649,85.46470,26501
4418,cut4th,1,0.00377,22650,85.46847,26501
4419,Cutshadows,1,0.00377,22651,85.47225,26501
4420,cvenets,1,0.00377,22652,85.47602,26501
4421,cwilso03,1,0.00377,22653,85.47979,26501
4422,cwy57885142,1,0.00377,22654,85.48357,26501
4423,cxxCoolStar,1,0.00377,22655,85.48734,26501
4424,cyanogen12,1,0.00377,22656,85.49111,26501
4425,cyberbob61,1,0.00377,22657,85.49489,26501
4426,cyberhorsey,1,0.00377,22658,85.49866,26501
4427,cyiping,1,0.00377,22659,85.50243,26501
4428,cyniczhi,1,0.00377,22660,85.50621,26501
4429,cyrillicw,1,0.00377,22661,85.50998,26501
4430,cywang4,1,0.00377,22662,85.51375,26501
4431,d1ck50n,1,0.00377,22663,85.51753,26501
4432,d1rtym0nk3y,1,0.00377,22664,85.52130,26501
4433,d3vus,1,0.00377,22665,85.52507,26501
4434,d821776892,1,0.00377,22666,85.52885,26501
4435,DaazKu,1,0.00377,22667,85.53262,26501
4436,DAerov,1,0.00377,22668,85.53639,26501
4437,daichimukai,1,0.00377,22669,85.54017,26501
4438,dalapatid,1,0.00377,22670,85.54394,26501
4439,dalazx,1,0.00377,22671,85.54772,26501
4440,damiangarbacz,1,0.00377,22672,85.55149,26501
4441,damienpuig,1,0.00377,22673,85.55526,26501
4442,damieva,1,0.00377,22674,85.55904,26501
4443,damiscoulibaly,1,0.00377,22675,85.56281,26501
4444,dancysoft,1,0.00377,22676,85.56658,26501
4445,dangermike,1,0.00377,22677,85.57036,26501
4446,dangllucas,1,0.00377,22678,85.57413,26501
4447,dangolk,1,0.00377,22679,85.57790,26501
4448,daniel-almeida,1,0.00377,22680,85.58168,26501
4449,daniel-ewing,1,0.00377,22681,85.58545,26501
4450,danielmarzini,1,0.00377,22682,85.58922,26501
4451,danielpsf-grover,1,0.00377,22683,85.59300,26501
4452,danielstarck,1,0.00377,22684,85.59677,26501
4453,danieniemand,1,0.00377,22685,85.60054,26501
4454,danifofric,1,0.00377,22686,85.60432,26501
4455,dan-ih,1,0.00377,22687,85.60809,26501
4456,dani-newman,1,0.00377,22688,85.61186,26501
4457,danishhansari,1,0.00377,22689,85.61564,26501
4458,dannycao,1,0.00377,22690,85.61941,26501
4459,dan-ri,1,0.00377,22691,85.62318,26501
4460,dante-saggin,1,0.00377,22692,85.62696,26501
4461,danzelchen,1,0.00377,22693,85.63073,26501
4462,dao-duc-tung,1,0.00377,22694,85.63450,26501
4463,dardison,1,0.00377,22695,85.63828,26501
4464,darkowl91,1,0.00377,22696,85.64205,26501
4465,Darnele91,1,0.00377,22697,85.64582,26501
4466,darrylcauldwell,1,0.00377,22698,85.64960,26501
4467,Darshannraval,1,0.00377,22699,85.65337,26501
4468,darthale,1,0.00377,22700,85.65715,26501
4469,DarthSim,1,0.00377,22701,85.66092,26501
4470,darylac,1,0.00377,22702,85.66469,26501
4471,dascenciohz,1,0.00377,22703,85.66847,26501
4472,DasJayYa,1,0.00377,22704,85.67224,26501
4473,datadoggers,1,0.00377,22705,85.67601,26501
4474,datasunrise-github,1,0.00377,22706,85.67979,26501
4475,DataWorm,1,0.00377,22707,85.68356,26501
4476,daveczerniawski,1,0.00377,22708,85.68733,26501
4477,Dave-Lowndes,1,0.00377,22709,85.69111,26501
4478,dave-sekula,1,0.00377,22710,85.69488,26501
4479,davesiracusa,1,0.00377,22711,85.69865,26501
4480,davestrandburg,1,0.00377,22712,85.70243,26501
4481,davetapley,1,0.00377,22713,85.70620,26501
4482,davidh-unmind,1,0.00377,22714,85.70997,26501
4483,davidrios,1,0.00377,22715,85.71375,26501
4484,DavidSanchezAlvarez,1,0.00377,22716,85.71752,26501
4485,davidtam,1,0.00377,22717,85.72129,26501
4486,dawid-onito,1,0.00377,22718,85.72507,26501
4487,dawnliliming,1,0.00377,22719,85.72884,26501
4488,daydayupyjw,1,0.00377,22720,85.73261,26501
4489,dayeguilaiye,1,0.00377,22721,85.73639,26501
4490,daytonturner,1,0.00377,22722,85.74016,26501
4491,dbblackdiamond,1,0.00377,22723,85.74393,26501
4492,db-cataloge-db,1,0.00377,22724,85.74771,26501
4493,dbhd,1,0.00377,22725,85.75148,26501
4494,dcanadillas,1,0.00377,22726,85.75525,26501
4495,dcdennis,1,0.00377,22727,85.75903,26501
4496,dcortright,1,0.00377,22728,85.76280,26501
4497,ddl-wasanthag,1,0.00377,22729,85.76657,26501
4498,dduyngo,1,0.00377,22730,85.77035,26501
4499,deadwanderer,1,0.00377,22731,85.77412,26501
4500,december1981,1,0.00377,22732,85.77790,26501
4501,DeChinees,1,0.00377,22733,85.78167,26501
4502,deckerp,1,0.00377,22734,85.78544,26501
4503,dedronek,1,0.00377,22735,85.78922,26501
4504,deedeky,1,0.00377,22736,85.79299,26501
4505,deep1910,1,0.00377,22737,85.79676,26501
4506,deepakjeena,1,0.00377,22738,85.80054,26501
4507,deepakky25,1,0.00377,22739,85.80431,26501
4508,deepeshhitachi,1,0.00377,22740,85.80808,26501
4509,Deepthichandrashekar,1,0.00377,22741,85.81186,26501
4510,defied,1,0.00377,22742,85.81563,26501
4511,dejanmarich,1,0.00377,22743,85.81940,26501
4512,dengbei-victor,1,0.00377,22744,85.82318,26501
4513,deniojunior,1,0.00377,22745,85.82695,26501
4514,denis-egorov-sxp,1,0.00377,22746,85.83072,26501
4515,dennbagas,1,0.00377,22747,85.83450,26501
4516,denniskniep,1,0.00377,22748,85.83827,26501
4517,dennisvandehoef,1,0.00377,22749,85.84204,26501
4518,derage,1,0.00377,22750,85.84582,26501
4519,dermoritz,1,0.00377,22751,85.84959,26501
4520,detlevvandaele-tomtom,1,0.00377,22752,85.85336,26501
4521,devansh-m12,1,0.00377,22753,85.85714,26501
4522,devatkc,1,0.00377,22754,85.86091,26501
4523,Devatorres9,1,0.00377,22755,85.86468,26501
4524,devendrakumar9-deloitte,1,0.00377,22756,85.86846,26501
4525,devinsaini,1,0.00377,22757,85.87223,26501
4526,devops1319,1,0.00377,22758,85.87600,26501
4527,devopslearn21,1,0.00377,22759,85.87978,26501
4528,devops-munju,1,0.00377,22760,85.88355,26501
4529,devopspln,1,0.00377,22761,85.88733,26501
4530,devttao,1,0.00377,22762,85.89110,26501
4531,devvick,1,0.00377,22763,85.89487,26501
4532,deweyjose,1,0.00377,22764,85.89865,26501
4533,dezmui,1,0.00377,22765,85.90242,26501
4534,dfcastro1,1,0.00377,22766,85.90619,26501
4535,dfoulkes,1,0.00377,22767,85.90997,26501
4536,dginzbourg,1,0.00377,22768,85.91374,26501
4537,dg-it,1,0.00377,22769,85.91751,26501
4538,dgmorales,1,0.00377,22770,85.92129,26501
4539,dhaldergit,1,0.00377,22771,85.92506,26501
4540,dhartimakwana,1,0.00377,22772,85.92883,26501
4541,dhayhak,1,0.00377,22773,85.93261,26501
4542,dhruv-chavda-mt,1,0.00377,22774,85.93638,26501
4543,Dhruv-Soni,1,0.00377,22775,85.94015,26501
4544,dhumphries-sainsburys,1,0.00377,22776,85.94393,26501
4545,DHydrogen,1,0.00377,22777,85.94770,26501
4546,diegoh,1,0.00377,22778,85.95147,26501
4547,diegonicacio,1,0.00377,22779,85.95525,26501
4548,dienbio,1,0.00377,22780,85.95902,26501
4549,diffusedlogic,1,0.00377,22781,85.96279,26501
4550,digdiego13,1,0.00377,22782,85.96657,26501
4551,digital88,1,0.00377,22783,85.97034,26501
4552,digitalbanana,1,0.00377,22784,85.97411,26501
4553,dilipgb,1,0.00377,22785,85.97789,26501
4554,dimamo5,1,0.00377,22786,85.98166,26501
4555,dimatomp,1,0.00377,22787,85.98543,26501
4556,dimaulupov,1,0.00377,22788,85.98921,26501
4557,DimitarHKostov,1,0.00377,22789,85.99298,26501
4558,dimitrigeo,1,0.00377,22790,85.99675,26501
4559,dineshk26,1,0.00377,22791,86.00053,26501
4560,dingbb,1,0.00377,22792,86.00430,26501
4561,DinoVino,1,0.00377,22793,86.00808,26501
4562,dinukarajapaksha,1,0.00377,22794,86.01185,26501
4563,diogotorres97,1,0.00377,22795,86.01562,26501
4564,diptripa,1,0.00377,22796,86.01940,26501
4565,dirodriguezm,1,0.00377,22797,86.02317,26501
4566,DiV666,1,0.00377,22798,86.02694,26501
4567,diversit,1,0.00377,22799,86.03072,26501
4568,divyanjali1,1,0.00377,22800,86.03449,26501
4569,Diwan9527,1,0.00377,22801,86.03826,26501
4570,dixitrathi7,1,0.00377,22802,86.04204,26501
4571,dixonqin,1,0.00377,22803,86.04581,26501
4572,DjaouadNM,1,0.00377,22804,86.04958,26501
4573,DjoleLepi,1,0.00377,22805,86.05336,26501
4574,dkdlv,1,0.00377,22806,86.05713,26501
4575,dleporis,1,0.00377,22807,86.06090,26501
4576,dlspears,1,0.00377,22808,86.06468,26501
4577,dlvenable,1,0.00377,22809,86.06845,26501
4578,dmadunic,1,0.00377,22810,86.07222,26501
4579,dmamchyts,1,0.00377,22811,86.07600,26501
4580,dmattia,1,0.00377,22812,86.07977,26501
4581,dmcwhorter-ddl,1,0.00377,22813,86.08354,26501
4582,dmierm,1,0.00377,22814,86.08732,26501
4583,dmikheeva,1,0.00377,22815,86.09109,26501
4584,dmitrybabanovforreal,1,0.00377,22816,86.09486,26501
4585,dmitryshelomanov,1,0.00377,22817,86.09864,26501
4586,dmitryuk,1,0.00377,22818,86.10241,26501
4587,dmiyamasu,1,0.00377,22819,86.10618,26501
4588,dml872,1,0.00377,22820,86.10996,26501
4589,dmortim,1,0.00377,22821,86.11373,26501
4590,dmouse,1,0.00377,22822,86.11750,26501
4591,dnie,1,0.00377,22823,86.12128,26501
4592,dnz-siliang,1,0.00377,22824,86.12505,26501
4593,doanphihai,1,0.00377,22825,86.12883,26501
4594,doctaweeks,1,0.00377,22826,86.13260,26501
4595,Dog4j,1,0.00377,22827,86.13637,26501
4596,dok8s,1,0.00377,22828,86.14015,26501
4597,dominicmarino,1,0.00377,22829,86.14392,26501
4598,Do-min-ik,1,0.00377,22830,86.14769,26501
4599,dominikdrzewiecki-tomtom,1,0.00377,22831,86.15147,26501
4600,domjancik,1,0.00377,22832,86.15524,26501
4601,domokost,1,0.00377,22833,86.15901,26501
4602,dongjieh,1,0.00377,22834,86.16279,26501
4603,donhector,1,0.00377,22835,86.16656,26501
4604,donicrosby,1,0.00377,22836,86.17033,26501
4605,donis,1,0.00377,22837,86.17411,26501
4606,donnol,1,0.00377,22838,86.17788,26501
4607,DopeforHope,1,0.00377,22839,86.18165,26501
4608,Dorivin,1,0.00377,22840,86.18543,26501
4609,doronbl,1,0.00377,22841,86.18920,26501
4610,Dovonun,1,0.00377,22842,86.19297,26501
4611,Dowster64,1,0.00377,22843,86.19675,26501
4612,dpx2016,1,0.00377,22844,86.20052,26501
4613,Drachen-Star,1,0.00377,22845,86.20429,26501
4614,DrBlury,1,0.00377,22846,86.20807,26501
4615,dre2004,1,0.00377,22847,86.21184,26501
4616,dreglad,1,0.00377,22848,86.21561,26501
4617,drewagentsync,1,0.00377,22849,86.21939,26501
4618,drimailorr,1,0.00377,22850,86.22316,26501
4619,droberts-abacussystems,1,0.00377,22851,86.22693,26501
4620,dryleaf,1,0.00377,22852,86.23071,26501
4621,dsaimukund,1,0.00377,22853,86.23448,26501
4622,dsharma-dc,1,0.00377,22854,86.23826,26501
4623,dsills-monumental,1,0.00377,22855,86.24203,26501
4624,dstandish,1,0.00377,22856,86.24580,26501
4625,dstevensson,1,0.00377,22857,86.24958,26501
4626,dthakkar-avnio,1,0.00377,22858,86.25335,26501
4627,dtivel,1,0.00377,22859,86.25712,26501
4628,Duanjax,1,0.00377,22860,86.26090,26501
4629,DUBANGARCIA,1,0.00377,22861,86.26467,26501
4630,dukanto,1,0.00377,22862,86.26844,26501
4631,Duke1616,1,0.00377,22863,86.27222,26501
4632,dukesilverr,1,0.00377,22864,86.27599,26501
4633,duncanworthy,1,0.00377,22865,86.27976,26501
4634,duncanwraight,1,0.00377,22866,86.28354,26501
4635,dung-tien-nguyen,1,0.00377,22867,86.28731,26501
4636,duongmn89,1,0.00377,22868,86.29108,26501
4637,Durganula,1,0.00377,22869,86.29486,26501
4638,DusanNikolic11,1,0.00377,22870,86.29863,26501
4639,dushyy,1,0.00377,22871,86.30240,26501
4640,dustinmhorvath,1,0.00377,22872,86.30618,26501
4641,duwenice,1,0.00377,22873,86.30995,26501
4642,duxbuse,1,0.00377,22874,86.31372,26501
4643,dv01d,1,0.00377,22875,86.31750,26501
4644,DV126,1,0.00377,22876,86.32127,26501
4645,dvb-simp,1,0.00377,22877,86.32504,26501
4646,dvcrn,1,0.00377,22878,86.32882,26501
4647,dvgitit,1,0.00377,22879,86.33259,26501
4648,dvjjoling,1,0.00377,22880,86.33636,26501
4649,dylan-bourque,1,0.00377,22881,86.34014,26501
4650,dywalsh-ar,1,0.00377,22882,86.34391,26501
4651,dz0080,1,0.00377,22883,86.34768,26501
4652,dzabel,1,0.00377,22884,86.35146,26501
4653,dzavalkin-scayle,1,0.00377,22885,86.35523,26501
4654,dzc15331066,1,0.00377,22886,86.35901,26501
4655,Dzulfikar-git,1,0.00377,22887,86.36278,26501
4656,dzyanis,1,0.00377,22888,86.36655,26501
4657,E11esh,1,0.00377,22889,86.37033,26501
4658,eagerashwani,1,0.00377,22890,86.37410,26501
4659,earik87,1,0.00377,22891,86.37787,26501
4660,eastwood-c,1,0.00377,22892,86.38165,26501
4661,Eazybright,1,0.00377,22893,86.38542,26501
4662,ebCrypto,1,0.00377,22894,86.38919,26501
4663,eben-roux,1,0.00377,22895,86.39297,26501
4664,echooymxq,1,0.00377,22896,86.39674,26501
4665,echung808,1,0.00377,22897,86.40051,26501
4666,edalorzo,1,0.00377,22898,86.40429,26501
4667,eddyashton,1,0.00377,22899,86.40806,26501
4668,edeln,1,0.00377,22900,86.41183,26501
4669,EdmondShtogu,1,0.00377,22901,86.41561,26501
4670,eduardborges,1,0.00377,22902,86.41938,26501
4671,eduardojunio,1,0.00377,22903,86.42315,26501
4672,edubois10,1,0.00377,22904,86.42693,26501
4673,eduherraiz,1,0.00377,22905,86.43070,26501
4674,EduSemensati,1,0.00377,22906,86.43447,26501
4675,eeromakiesko,1,0.00377,22907,86.43825,26501
4676,egvijayanand,1,0.00377,22908,86.44202,26501
4677,egypjoy,1,0.00377,22909,86.44579,26501
4678,ehanks-habana,1,0.00377,22910,86.44957,26501
4679,ehassan1312,1,0.00377,22911,86.45334,26501
4680,ehausig,1,0.00377,22912,86.45711,26501
4681,eHildy,1,0.00377,22913,86.46089,26501
4682,eholman,1,0.00377,22914,86.46466,26501
4683,ehsanpo,1,0.00377,22915,86.46844,26501
4684,ehtb,1,0.00377,22916,86.47221,26501
4685,eighteight,1,0.00377,22917,86.47598,26501
4686,Eiskasten,1,0.00377,22918,86.47976,26501
4687,eitkin-nvidia,1,0.00377,22919,86.48353,26501
4688,eive001,1,0.00377,22920,86.48730,26501
4689,ejennings95,1,0.00377,22921,86.49108,26501
4690,ekrasnoyarov,1,0.00377,22922,86.49485,26501
4691,EKrol2,1,0.00377,22923,86.49862,26501
4692,ekxxsho,1,0.00377,22924,86.50240,26501
4693,eladmaimoni,1,0.00377,22925,86.50617,26501
4694,elanuser,1,0.00377,22926,86.50994,26501
4695,elaous,1,0.00377,22927,86.51372,26501
4696,elebiodaslingshot,1,0.00377,22928,86.51749,26501
4697,elementljarredc,1,0.00377,22929,86.52126,26501
4698,elendis,1,0.00377,22930,86.52504,26501
4699,eliax1996,1,0.00377,22931,86.52881,26501
4700,elicore,1,0.00377,22932,86.53258,26501
4701,elieassi,1,0.00377,22933,86.53636,26501
4702,elisselockhart,1,0.00377,22934,86.54013,26501
4703,elliottpope,1,0.00377,22935,86.54390,26501
4704,elmerfud,1,0.00377,22936,86.54768,26501
4705,elsoft007,1,0.00377,22937,86.55145,26501
4706,emagana-splunk,1,0.00377,22938,86.55522,26501
4707,emanserav,1,0.00377,22939,86.55900,26501
4708,emanuelschmoczer,1,0.00377,22940,86.56277,26501
4709,emileturcotte,1,0.00377,22941,86.56654,26501
4710,eminden,1,0.00377,22942,86.57032,26501
4711,empereira,1,0.00377,22943,86.57409,26501
4712,Emranshaikk,1,0.00377,22944,86.57786,26501
4713,emreigrek,1,0.00377,22945,86.58164,26501
4714,emvidi,1,0.00377,22946,86.58541,26501
4715,enavarre-cl,1,0.00377,22947,86.58919,26501
4716,encorew,1,0.00377,22948,86.59296,26501
4717,EndGaurav,1,0.00377,22949,86.59673,26501
4718,enesconf,1,0.00377,22950,86.60051,26501
4719,EnesKaraosman,1,0.00377,22951,86.60428,26501
4720,enstenr,1,0.00377,22952,86.60805,26501
4721,epictralala,1,0.00377,22953,86.61183,26501
4722,erdogancel,1,0.00377,22954,86.61560,26501
4723,ergonjona,1,0.00377,22955,86.61937,26501
4724,ericklaus-wf,1,0.00377,22956,86.62315,26501
4725,EricLiuRan,1,0.00377,22957,86.62692,26501
4726,EricWangPX,1,0.00377,22958,86.63069,26501
4727,Ericwonne,1,0.00377,22959,86.63447,26501
4728,erighi,1,0.00377,22960,86.63824,26501
4729,erikdeweerdt,1,0.00377,22961,86.64201,26501
4730,erikjw,1,0.00377,22962,86.64579,26501
4731,ErKaramSingh,1,0.00377,22963,86.64956,26501
4732,erose96,1,0.00377,22964,86.65333,26501
4733,ErvalhouS,1,0.00377,22965,86.65711,26501
4734,erzohrakhan,1,0.00377,22966,86.66088,26501
4735,es,1,0.00377,22967,86.66465,26501
4736,esalter,1,0.00377,22968,86.66843,26501
4737,escos,1,0.00377,22969,86.67220,26501
4738,essen,1,0.00377,22970,86.67597,26501
4739,estack,1,0.00377,22971,86.67975,26501
4740,estebancano-dev,1,0.00377,22972,86.68352,26501
4741,estif95,1,0.00377,22973,86.68729,26501
4742,etghanibahman,1,0.00377,22974,86.69107,26501
4743,EthanSherr,1,0.00377,22975,86.69484,26501
4744,ethfoo,1,0.00377,22976,86.69862,26501
4745,etiennecl,1,0.00377,22977,86.70239,26501
4746,EtienneExalgo,1,0.00377,22978,86.70616,26501
4747,etokarev,1,0.00377,22979,86.70994,26501
4748,etokheim,1,0.00377,22980,86.71371,26501
4749,eudore,1,0.00377,22981,86.71748,26501
4750,evairmarinho,1,0.00377,22982,86.72126,26501
4751,evan-hines-js,1,0.00377,22983,86.72503,26501
4752,EvanYen,1,0.00377,22984,86.72880,26501
4753,everactivetim,1,0.00377,22985,86.73258,26501
4754,EverGuzman,1,0.00377,22986,86.73635,26501
4755,evolve75,1,0.00377,22987,86.74012,26501
4756,evsasha,1,0.00377,22988,86.74390,26501
4757,evyros,1,0.00377,22989,86.74767,26501
4758,exArax,1,0.00377,22990,86.75144,26501
4759,EyalAr,1,0.00377,22991,86.75522,26501
4760,ezracelli,1,0.00377,22992,86.75899,26501
4761,f1ames0ff,1,0.00377,22993,86.76276,26501
4762,f3r73ch,1,0.00377,22994,86.76654,26501
4763,f4x15,1,0.00377,22995,86.77031,26501
4764,fabian12rodriguez,1,0.00377,22996,86.77408,26501
4765,fabioespinosa,1,0.00377,22997,86.77786,26501
4766,fab-mindflow,1,0.00377,22998,86.78163,26501
4767,fabry00,1,0.00377,22999,86.78540,26501
4768,Facecasino,1,0.00377,23000,86.78918,26501
4769,faganihajizada,1,0.00377,23001,86.79295,26501
4770,faisaleem-na,1,0.00377,23002,86.79672,26501
4771,fallobst22,1,0.00377,23003,86.80050,26501
4772,falsedlah,1,0.00377,23004,86.80427,26501
4773,falyoun,1,0.00377,23005,86.80804,26501
4774,fandy-fan,1,0.00377,23006,86.81182,26501
4775,fantasyhh,1,0.00377,23007,86.81559,26501
4776,fanzhe328,1,0.00377,23008,86.81937,26501
4777,farahtk,1,0.00377,23009,86.82314,26501
4778,far-blue,1,0.00377,23010,86.82691,26501
4779,FaresHerhar,1,0.00377,23011,86.83069,26501
4780,Faresman2,1,0.00377,23012,86.83446,26501
4781,Farmankhan733,1,0.00377,23013,86.83823,26501
4782,FatemehRahmanzadeh,1,0.00377,23014,86.84201,26501
4783,faynburd,1,0.00377,23015,86.84578,26501
4784,fbjorn,1,0.00377,23016,86.84955,26501
4785,fdiskbrain,1,0.00377,23017,86.85333,26501
4786,fdzfd,1,0.00377,23018,86.85710,26501
4787,fe-dagostino,1,0.00377,23019,86.86087,26501
4788,fede843,1,0.00377,23020,86.86465,26501
4789,federicobond,1,0.00377,23021,86.86842,26501
4790,fedorovdima,1,0.00377,23022,86.87219,26501
4791,feldentm-SAP,1,0.00377,23023,86.87597,26501
4792,felinae98,1,0.00377,23024,86.87974,26501
4793,felipenferri,1,0.00377,23025,86.88351,26501
4794,felipetssilva,1,0.00377,23026,86.88729,26501
4795,felix-gohla,1,0.00377,23027,86.89106,26501
4796,Felk,1,0.00377,23028,86.89483,26501
4797,felleg,1,0.00377,23029,86.89861,26501
4798,femio27,1,0.00377,23030,86.90238,26501
4799,fengweiqiang,1,0.00377,23031,86.90615,26501
4800,ferm10n,1,0.00377,23032,86.90993,26501
4801,FernandezMathieu,1,0.00377,23033,86.91370,26501
4802,ferrisz,1,0.00377,23034,86.91747,26501
4803,ffendt,1,0.00377,23035,86.92125,26501
4804,fhennig,1,0.00377,23036,86.92502,26501
4805,filiprejmus,1,0.00377,23037,86.92880,26501
4806,Filmaluco,1,0.00377,23038,86.93257,26501
4807,FilRav,1,0.00377,23039,86.93634,26501
4808,finance-dataspider,1,0.00377,23040,86.94012,26501
4809,Fishrock123,1,0.00377,23041,86.94389,26501
4810,FiV0,1,0.00377,23042,86.94766,26501
4811,fivaldi,1,0.00377,23043,86.95144,26501
4812,five111,1,0.00377,23044,86.95521,26501
4813,fixdb,1,0.00377,23045,86.95898,26501
4814,fjanicki,1,0.00377,23046,86.96276,26501
4815,fkazem,1,0.00377,23047,86.96653,26501
4816,fklassen,1,0.00377,23048,86.97030,26501
4817,flashmann,1,0.00377,23049,86.97408,26501
4818,flashpaper12,1,0.00377,23050,86.97785,26501
4819,flaussmann,1,0.00377,23051,86.98162,26501
4820,fleadope,1,0.00377,23052,86.98540,26501
4821,fleetingtimer,1,0.00377,23053,86.98917,26501
4822,fletchgqc,1,0.00377,23054,86.99294,26501
4823,flippingflapping,1,0.00377,23055,86.99672,26501
4824,f-lira,1,0.00377,23056,87.00049,26501
4825,flixman,1,0.00377,23057,87.00426,26501
4826,flomader,1,0.00377,23058,87.00804,26501
4827,floozy,1,0.00377,23059,87.01181,26501
4828,floralatin,1,0.00377,23060,87.01558,26501
4829,FlorianLoch,1,0.00377,23061,87.01936,26501
4830,florianrusch-cluetec,1,0.00377,23062,87.02313,26501
4831,florianrusch-zf,1,0.00377,23063,87.02690,26501
4832,Flyalay,1,0.00377,23064,87.03068,26501
4833,flyflyhe,1,0.00377,23065,87.03445,26501
4834,fnadeau,1,0.00377,23066,87.03822,26501
4835,fniephaus,1,0.00377,23067,87.04200,26501
4836,fonok3,1,0.00377,23068,87.04577,26501
4837,fontexD,1,0.00377,23069,87.04955,26501
4838,foo-dogsquared,1,0.00377,23070,87.05332,26501
4839,fortuna,1,0.00377,23071,87.05709,26501
4840,fosmjo,1,0.00377,23072,87.06087,26501
4841,foxwsp,1,0.00377,23073,87.06464,26501
4842,fp-big5,1,0.00377,23074,87.06841,26501
4843,fprotimaru,1,0.00377,23075,87.07219,26501
4844,fraima,1,0.00377,23076,87.07596,26501
4845,franciscaGrandon,1,0.00377,23077,87.07973,26501
4846,franckya,1,0.00377,23078,87.08351,26501
4847,franco87,1,0.00377,23079,87.08728,26501
4848,frankiefoo-i,1,0.00377,23080,87.09105,26501
4849,franklange,1,0.00377,23081,87.09483,26501
4850,franzqat,1,0.00377,23082,87.09860,26501
4851,fredericdalleau,1,0.00377,23083,87.10237,26501
4852,fred-lix,1,0.00377,23084,87.10615,26501
4853,FredMandry,1,0.00377,23085,87.10992,26501
4854,fredpan,1,0.00377,23086,87.11369,26501
4855,FredrikFolkeryd,1,0.00377,23087,87.11747,26501
4856,Fred-supre,1,0.00377,23088,87.12124,26501
4857,freemanjustin,1,0.00377,23089,87.12501,26501
4858,free-y,1,0.00377,23090,87.12879,26501
4859,frisbee23,1,0.00377,23091,87.13256,26501
4860,frit0-rb,1,0.00377,23092,87.13633,26501
4861,Fritte795,1,0.00377,23093,87.14011,26501
4862,fritterhoff,1,0.00377,23094,87.14388,26501
4863,FrogWithASock,1,0.00377,23095,87.14765,26501
4864,frylion007,1,0.00377,23096,87.15143,26501
4865,fsal,1,0.00377,23097,87.15520,26501
4866,fsan,1,0.00377,23098,87.15898,26501
4867,fschulte-eiwa,1,0.00377,23099,87.16275,26501
4868,FSys77,1,0.00377,23100,87.16652,26501
4869,ftasbasi,1,0.00377,23101,87.17030,26501
4870,ftpd,1,0.00377,23102,87.17407,26501
4871,fulcrum29,1,0.00377,23103,87.17784,26501
4872,fullonic,1,0.00377,23104,87.18162,26501
4873,fuping-han,1,0.00377,23105,87.18539,26501
4874,Futrime,1,0.00377,23106,87.18916,26501
4875,futurist,1,0.00377,23107,87.19294,26501
4876,fuxp3,1,0.00377,23108,87.19671,26501
4877,fyannk,1,0.00377,23109,87.20048,26501
4878,FYGonzalo,1,0.00377,23110,87.20426,26501
4879,Gabizar,1,0.00377,23111,87.20803,26501
4880,gabomarf,1,0.00377,23112,87.21180,26501
4881,gaborbodis,1,0.00377,23113,87.21558,26501
4882,gabrielbussolo,1,0.00377,23114,87.21935,26501
4883,GabrielCavalloRL,1,0.00377,23115,87.22312,26501
4884,gabriel-cx,1,0.00377,23116,87.22690,26501
4885,GabriFedi97,1,0.00377,23117,87.23067,26501
4886,gabrimonfa,1,0.00377,23118,87.23444,26501
4887,gandhisagar,1,0.00377,23119,87.23822,26501
4888,ganeshrraorane,1,0.00377,23120,87.24199,26501
4889,ganeshsnp987,1,0.00377,23121,87.24576,26501
4890,Gaozizhong,1,0.00377,23122,87.24954,26501
4891,Garen-in-bush,1,0.00377,23123,87.25331,26501
4892,garrett-partenza-us,1,0.00377,23124,87.25708,26501
4893,garryqian,1,0.00377,23125,87.26086,26501
4894,garvit-cosmofeed,1,0.00377,23126,87.26463,26501
4895,gary-scio,1,0.00377,23127,87.26840,26501
4896,GaryTopHat,1,0.00377,23128,87.27218,26501
4897,gashof,1,0.00377,23129,87.27595,26501
4898,Gateway85,1,0.00377,23130,87.27973,26501
4899,gatspy,1,0.00377,23131,87.28350,26501
4900,gauravesds,1,0.00377,23132,87.28727,26501
4901,Gauravpawar3102,1,0.00377,23133,87.29105,26501
4902,gauravvats-ingka,1,0.00377,23134,87.29482,26501
4903,gautamtada,1,0.00377,23135,87.29859,26501
4904,GazdaPL,1,0.00377,23136,87.30237,26501
4905,gbenga2686,1,0.00377,23137,87.30614,26501
4906,gbhi,1,0.00377,23138,87.30991,26501
4907,GCES-Kubernetes-2022-2,1,0.00377,23139,87.31369,26501
4908,gchhablani,1,0.00377,23140,87.31746,26501
4909,g-clef,1,0.00377,23141,87.32123,26501
4910,gebhardtr,1,0.00377,23142,87.32501,26501
4911,geborgeson,1,0.00377,23143,87.32878,26501
4912,geminiyellow,1,0.00377,23144,87.33255,26501
4913,genglj,1,0.00377,23145,87.33633,26501
4914,geniuslc11,1,0.00377,23146,87.34010,26501
4915,gentoorax,1,0.00377,23147,87.34387,26501
4916,Genysys,1,0.00377,23148,87.34765,26501
4917,georgeh,1,0.00377,23149,87.35142,26501
4918,georgemayrin,1,0.00377,23150,87.35519,26501
4919,gerethd,1,0.00377,23151,87.35897,26501
4920,GermanKingYT,1,0.00377,23152,87.36274,26501
4921,getmonyinfo,1,0.00377,23153,87.36651,26501
4922,gezhigezhige,1,0.00377,23154,87.37029,26501
4923,gfafonso,1,0.00377,23155,87.37406,26501
4924,gforster,1,0.00377,23156,87.37783,26501
4925,gfszr,1,0.00377,23157,87.38161,26501
4926,ghandic,1,0.00377,23158,87.38538,26501
4927,ghbeta,1,0.00377,23159,87.38916,26501
4928,ghinks,1,0.00377,23160,87.39293,26501
4929,gibachan,1,0.00377,23161,87.39670,26501
4930,gilbrown123,1,0.00377,23162,87.40048,26501
4931,gilgoodridge,1,0.00377,23163,87.40425,26501
4932,gillarda,1,0.00377,23164,87.40802,26501
4933,gillerst1,1,0.00377,23165,87.41180,26501
4934,giriraj-hh,1,0.00377,23166,87.41557,26501
4935,GirishCB,1,0.00377,23167,87.41934,26501
4936,gitarbaz,1,0.00377,23168,87.42312,26501
4937,gitdanyo,1,0.00377,23169,87.42689,26501
4938,gitfirenz,1,0.00377,23170,87.43066,26501
4939,gitgithan,1,0.00377,23171,87.43444,26501
4940,github4sanjay,1,0.00377,23172,87.43821,26501
4941,GitHubAmos,1,0.00377,23173,87.44198,26501
4942,gitkr999,1,0.00377,23174,87.44576,26501
4943,giuliocalzolari,1,0.00377,23175,87.44953,26501
4944,giupb,1,0.00377,23176,87.45330,26501
4945,gj199575,1,0.00377,23177,87.45708,26501
4946,Gladdstone,1,0.00377,23178,87.46085,26501
4947,glin-gogogo,1,0.00377,23179,87.46462,26501
4948,GlobeFishNG,1,0.00377,23180,87.46840,26501
4949,glu0516,1,0.00377,23181,87.47217,26501
4950,Glusk,1,0.00377,23182,87.47594,26501
4951,Glutamat42,1,0.00377,23183,87.47972,26501
4952,gmarano,1,0.00377,23184,87.48349,26501
4953,gmarks-ntap,1,0.00377,23185,87.48726,26501
4954,gmbeneva,1,0.00377,23186,87.49104,26501
4955,gn-smals,1,0.00377,23187,87.49481,26501
4956,gobraves,1,0.00377,23188,87.49858,26501
4957,gocpplua,1,0.00377,23189,87.50236,26501
4958,godfatherdemon,1,0.00377,23190,87.50613,26501
4959,GogolTsk,1,0.00377,23191,87.50991,26501
4960,goldalworming,1,0.00377,23192,87.51368,26501
4961,goldenc,1,0.00377,23193,87.51745,26501
4962,GoldenCave,1,0.00377,23194,87.52123,26501
4963,goldiee36,1,0.00377,23195,87.52500,26501
4964,golf-mike,1,0.00377,23196,87.52877,26501
4965,goofiw,1,0.00377,23197,87.53255,26501
4966,googleg,1,0.00377,23198,87.53632,26501
4967,Gorgeous-Patrick,1,0.00377,23199,87.54009,26501
4968,gorkemgoknar,1,0.00377,23200,87.54387,26501
4969,gourishkb,1,0.00377,23201,87.54764,26501
4970,GouseAligne,1,0.00377,23202,87.55141,26501
4971,gouslu,1,0.00377,23203,87.55519,26501
4972,gouthamMN,1,0.00377,23204,87.55896,26501
4973,goutham-sabapathy,1,0.00377,23205,87.56273,26501
4974,Govardhandamam,1,0.00377,23206,87.56651,26501
4975,govindpawa,1,0.00377,23207,87.57028,26501
4976,gpedras,1,0.00377,23208,87.57405,26501
4977,gpramita,1,0.00377,23209,87.57783,26501
4978,graemechristie,1,0.00377,23210,87.58160,26501
4979,graysonhead,1,0.00377,23211,87.58537,26501
4980,GreatGhostsss,1,0.00377,23212,87.58915,26501
4981,gregkonush,1,0.00377,23213,87.59292,26501
4982,GregLahaye,1,0.00377,23214,87.59669,26501
4983,Gresdy,1,0.00377,23215,87.60047,26501
4984,grglzrv,1,0.00377,23216,87.60424,26501
4985,grigorizaika1,1,0.00377,23217,87.60801,26501
4986,grk,1,0.00377,23218,87.61179,26501
4987,grmaltby,1,0.00377,23219,87.61556,26501
4988,gromnsk,1,0.00377,23220,87.61934,26501
4989,groovecoding7,1,0.00377,23221,87.62311,26501
4990,groteck,1,0.00377,23222,87.62688,26501
4991,grufino-blackbird,1,0.00377,23223,87.63066,26501
4992,grzegorzewskiflyingdog,1,0.00377,23224,87.63443,26501
4993,gsamokovarov,1,0.00377,23225,87.63820,26501
4994,GSeibt,1,0.00377,23226,87.64198,26501
4995,gsustek,1,0.00377,23227,87.64575,26501
4996,GuangFeiZHU,1,0.00377,23228,87.64952,26501
4997,guchaoping,1,0.00377,23229,87.65330,26501
4998,GudaboinaSuhas,1,0.00377,23230,87.65707,26501
4999,guidemetothemoon,1,0.00377,23231,87.66084,26501
5000,GuillaumeDerivery,1,0.00377,23232,87.66462,26501
5001,guillemlc,1,0.00377,23233,87.66839,26501
5002,guilr,1,0.00377,23234,87.67216,26501
5003,gumartinm,1,0.00377,23235,87.67594,26501
5004,Gumbert-Gumbert,1,0.00377,23236,87.67971,26501
5005,gun0317,1,0.00377,23237,87.68348,26501
5006,gunniLEE,1,0.00377,23238,87.68726,26501
5007,guoxiangzhou,1,0.00377,23239,87.69103,26501
5008,Guravareddy0479,1,0.00377,23240,87.69480,26501
5009,gustavoapolinario,1,0.00377,23241,87.69858,26501
5010,gutozntt,1,0.00377,23242,87.70235,26501
5011,guytet,1,0.00377,23243,87.70612,26501
5012,guyuhu,1,0.00377,23244,87.70990,26501
5013,gvangeel,1,0.00377,23245,87.71367,26501
5014,gwaydust,1,0.00377,23246,87.71744,26501
5015,gwer,1,0.00377,23247,87.72122,26501
5016,gwynnebaer,1,0.00377,23248,87.72499,26501
5017,gxxglyeyez,1,0.00377,23249,87.72876,26501
5018,GyaniRoman23,1,0.00377,23250,87.73254,26501
5019,gyuvaraj10,1,0.00377,23251,87.73631,26501
5020,h0ns0l0,1,0.00377,23252,87.74009,26501
5021,h2romero,1,0.00377,23253,87.74386,26501
5022,h326370,1,0.00377,23254,87.74763,26501
5023,H4LKEye,1,0.00377,23255,87.75141,26501
5024,haakobja,1,0.00377,23256,87.75518,26501
5025,Hacker-OH,1,0.00377,23257,87.75895,26501
5026,HaiderAli-everest,1,0.00377,23258,87.76273,26501
5027,haim-brum,1,0.00377,23259,87.76650,26501
5028,hakabo,1,0.00377,23260,87.77027,26501
5029,Hakuyume,1,0.00377,23261,87.77405,26501
5030,halamah,1,0.00377,23262,87.77782,26501
5031,halhenke,1,0.00377,23263,87.78159,26501
5032,Hallot,1,0.00377,23264,87.78537,26501
5033,hammoumi94,1,0.00377,23265,87.78914,26501
5034,hamzalsheikh,1,0.00377,23266,87.79291,26501
5035,HamzaM1,1,0.00377,23267,87.79669,26501
5036,HanGuangyu,1,0.00377,23268,87.80046,26501
5037,Hanif-aa,1,0.00377,23269,87.80423,26501
5038,hankhng,1,0.00377,23270,87.80801,26501
5039,hannah11361,1,0.00377,23271,87.81178,26501
5040,hannan-khan-intelops,1,0.00377,23272,87.81555,26501
5041,hannespfeiffer,1,0.00377,23273,87.81933,26501
5042,hanouard,1,0.00377,23274,87.82310,26501
5043,hanseltime,1,0.00377,23275,87.82687,26501
5044,hanshuishi,1,0.00377,23276,87.83065,26501
5045,hanskhe,1,0.00377,23277,87.83442,26501
5046,hantiancai,1,0.00377,23278,87.83819,26501
5047,haplone,1,0.00377,23279,87.84197,26501
5048,harisaisundhar,1,0.00377,23280,87.84574,26501
5049,Harnish,1,0.00377,23281,87.84952,26501
5050,Harsh-2002,1,0.00377,23282,87.85329,26501
5051,harshaisgud,1,0.00377,23283,87.85706,26501
5052,HarshalNeelkamal,1,0.00377,23284,87.86084,26501
5053,harshalzambre-TEKsystems-scm,1,0.00377,23285,87.86461,26501
5054,harshlancer,1,0.00377,23286,87.86838,26501
5055,HarshPathakhp,1,0.00377,23287,87.87216,26501
5056,harsiddhdave44,1,0.00377,23288,87.87593,26501
5057,HassanAbouelela,1,0.00377,23289,87.87970,26501
5058,hassanshamshir,1,0.00377,23290,87.88348,26501
5059,HatchBV,1,0.00377,23291,87.88725,26501
5060,Hazel0928,1,0.00377,23292,87.89102,26501
5061,Hazem-Al-Aqailah,1,0.00377,23293,87.89480,26501
5062,hbuckle,1,0.00377,23294,87.89857,26501
5063,hbyscx001,1,0.00377,23295,87.90234,26501
5064,hdeadman,1,0.00377,23296,87.90612,26501
5065,hdhoang,1,0.00377,23297,87.90989,26501
5066,hdxj-kaoy,1,0.00377,23298,87.91366,26501
5067,heismehrab,1,0.00377,23299,87.91744,26501
5068,heliochronix,1,0.00377,23300,87.92121,26501
5069,hellofinch,1,0.00377,23301,87.92498,26501
5070,Hellomik2002,1,0.00377,23302,87.92876,26501
5071,helloxk617,1,0.00377,23303,87.93253,26501
5072,Hemanthbhk,1,0.00377,23304,87.93630,26501
5073,henit-chobisa,1,0.00377,23305,87.94008,26501
5074,heph2,1,0.00377,23306,87.94385,26501
5075,herao67,1,0.00377,23307,87.94762,26501
5076,hera-user,1,0.00377,23308,87.95140,26501
5077,herawais,1,0.00377,23309,87.95517,26501
5078,hercial61,1,0.00377,23310,87.95894,26501
5079,hermantai,1,0.00377,23311,87.96272,26501
5080,hexian000,1,0.00377,23312,87.96649,26501
5081,heysagnik,1,0.00377,23313,87.97027,26501
5082,hfarooqui,1,0.00377,23314,87.97404,26501
5083,hftsin,1,0.00377,23315,87.97781,26501
5084,hicwic,1,0.00377,23316,87.98159,26501
5085,HillaShx,1,0.00377,23317,87.98536,26501
5086,himanshu1221,1,0.00377,23318,87.98913,26501
5087,himanshu8088,1,0.00377,23319,87.99291,26501
5088,HimanshuKapoor328,1,0.00377,23320,87.99668,26501
5089,himanshuupadhyay101,1,0.00377,23321,88.00045,26501
5090,hirenp,1,0.00377,23322,88.00423,26501
5091,hishampaloli,1,0.00377,23323,88.00800,26501
5092,hittaKAFFE,1,0.00377,23324,88.01177,26501
5093,hlastraspfx,1,0.00377,23325,88.01555,26501
5094,hmajid2301,1,0.00377,23326,88.01932,26501
5095,hoangtrucit,1,0.00377,23327,88.02309,26501
5096,HobbyBear,1,0.00377,23328,88.02687,26501
5097,Hoferl,1,0.00377,23329,88.03064,26501
5098,hokimr,1,0.00377,23330,88.03441,26501
5099,holdeneoneal,1,0.00377,23331,88.03819,26501
5100,holubales,1,0.00377,23332,88.04196,26501
5101,holwerda,1,0.00377,23333,88.04573,26501
5102,homeworkprod,1,0.00377,23334,88.04951,26501
5103,HongbingZhang,1,0.00377,23335,88.05328,26501
5104,hongcaohu,1,0.00377,23336,88.05705,26501
5105,hongwei-lv,1,0.00377,23337,88.06083,26501
5106,HongyanShen,1,0.00377,23338,88.06460,26501
5107,hoojos,1,0.00377,23339,88.06837,26501
5108,hopisaurus,1,0.00377,23340,88.07215,26501
5109,houfengjiejie,1,0.00377,23341,88.07592,26501
5110,HoustonDad,1,0.00377,23342,88.07970,26501
5111,houxul,1,0.00377,23343,88.08347,26501
5112,hox,1,0.00377,23344,88.08724,26501
5113,Hpd0ger,1,0.00377,23345,88.09102,26501
5114,hriddhighosh4,1,0.00377,23346,88.09479,26501
5115,hrider,1,0.00377,23347,88.09856,26501
5116,Hrishi-Bh,1,0.00377,23348,88.10234,26501
5117,hristopopov,1,0.00377,23349,88.10611,26501
5118,hsnprsd,1,0.00377,23350,88.10988,26501
5119,htbrandao,1,0.00377,23351,88.11366,26501
5120,huangzou70,1,0.00377,23352,88.11743,26501
5121,Hubert97,1,0.00377,23353,88.12120,26501
5122,HubertSzymanskiCDQ,1,0.00377,23354,88.12498,26501
5123,HubertZhang,1,0.00377,23355,88.12875,26501
5124,Huda-Almutairi,1,0.00377,23356,88.13252,26501
5125,hughjfchen,1,0.00377,23357,88.13630,26501
5126,HugoAreias,1,0.00377,23358,88.14007,26501
5127,humestc,1,0.00377,23359,88.14384,26501
5128,hummelm,1,0.00377,23360,88.14762,26501
5129,hungry1526,1,0.00377,23361,88.15139,26501
5130,hungtran84,1,0.00377,23362,88.15516,26501
5131,Hunrik,1,0.00377,23363,88.15894,26501
5132,husseinsa,1,0.00377,23364,88.16271,26501
5133,husy-dev,1,0.00377,23365,88.16648,26501
5134,huyaoban,1,0.00377,23366,88.17026,26501
5135,huyphan,1,0.00377,23367,88.17403,26501
5136,huzhenwei7z,1,0.00377,23368,88.17780,26501
5137,hvpareja,1,0.00377,23369,88.18158,26501
5138,hwanghakbeom,1,0.00377,23370,88.18535,26501
5139,HwiLu,1,0.00377,23371,88.18912,26501
5140,hydiar,1,0.00377,23372,88.19290,26501
5141,hyorimitsu,1,0.00377,23373,88.19667,26501
5142,Hyperzsb,1,0.00377,23374,88.20045,26501
5143,Hypoxicfire,1,0.00377,23375,88.20422,26501
5144,hyunkoes,1,0.00377,23376,88.20799,26501
5145,iainnicol,1,0.00377,23377,88.21177,26501
5146,IAlexEgorov,1,0.00377,23378,88.21554,26501
5147,iamishuverma,1,0.00377,23379,88.21931,26501
5148,iamlongalong,1,0.00377,23380,88.22309,26501
5149,iampramma,1,0.00377,23381,88.22686,26501
5150,iamryanchia,1,0.00377,23382,88.23063,26501
5151,ian471,1,0.00377,23383,88.23441,26501
5152,iateya,1,0.00377,23384,88.23818,26501
5153,ibacalu,1,0.00377,23385,88.24195,26501
5154,iburrows,1,0.00377,23386,88.24573,26501
5155,iceblove,1,0.00377,23387,88.24950,26501
5156,icerockq,1,0.00377,23388,88.25327,26501
5157,Ichimonji10,1,0.00377,23389,88.25705,26501
5158,icrdr,1,0.00377,23390,88.26082,26501
5159,ict-one-nl,1,0.00377,23391,88.26459,26501
5160,idanrookout,1,0.00377,23392,88.26837,26501
5161,Ido-Ozeri,1,0.00377,23393,88.27214,26501
5162,id-tari,1,0.00377,23394,88.27591,26501
5163,idumlija,1,0.00377,23395,88.27969,26501
5164,idurgakalyan,1,0.00377,23396,88.28346,26501
5165,ie-pham,1,0.00377,23397,88.28723,26501
5166,ifreespace,1,0.00377,23398,88.29101,26501
5167,igalvarez,1,0.00377,23399,88.29478,26501
5168,igimot,1,0.00377,23400,88.29855,26501
5169,IgorBerman,1,0.00377,23401,88.30233,26501
5170,Igorgro,1,0.00377,23402,88.30610,26501
5171,igorzamyslov,1,0.00377,23403,88.30988,26501
5172,ilclaudio,1,0.00377,23404,88.31365,26501
5173,Ilium77,1,0.00377,23405,88.31742,26501
5174,ilka-schulz,1,0.00377,23406,88.32120,26501
5175,IlliaZhaglov,1,0.00377,23407,88.32497,26501
5176,ilolicon,1,0.00377,23408,88.32874,26501
5177,ilteristabak,1,0.00377,23409,88.33252,26501
5178,ilyassikai,1,0.00377,23410,88.33629,26501
5179,Imartinn,1,0.00377,23411,88.34006,26501
5180,imballinst,1,0.00377,23412,88.34384,26501
5181,IMBiXx,1,0.00377,23413,88.34761,26501
5182,indestructible2,1,0.00377,23414,88.35138,26501
5183,infa-rahusingh,1,0.00377,23415,88.35516,26501
5184,inFocus7,1,0.00377,23416,88.35893,26501
5185,initharrington,1,0.00377,23417,88.36270,26501
5186,integrous,1,0.00377,23418,88.36648,26501
5187,iocusdigital,1,0.00377,23419,88.37025,26501
5188,ionics,1,0.00377,23420,88.37402,26501
5189,ipHeaders,1,0.00377,23421,88.37780,26501
5190,ipsi,1,0.00377,23422,88.38157,26501
5191,iqbalkhan82,1,0.00377,23423,88.38534,26501
5192,irab,1,0.00377,23424,88.38912,26501
5193,IRusio,1,0.00377,23425,88.39289,26501
5194,irwinbraganza,1,0.00377,23426,88.39666,26501
5195,isabelle-snyder,1,0.00377,23427,88.40044,26501
5196,isanchen,1,0.00377,23428,88.40421,26501
5197,iscultas,1,0.00377,23429,88.40798,26501
5198,ishergin,1,0.00377,23430,88.41176,26501
5199,iskandertajine,1,0.00377,23431,88.41553,26501
5200,ism-k,1,0.00377,23432,88.41930,26501
5201,ItaloChagas,1,0.00377,23433,88.42308,26501
5202,Itellissi,1,0.00377,23434,88.42685,26501
5203,ithesadson,1,0.00377,23435,88.43063,26501
5204,ito123456,1,0.00377,23436,88.43440,26501
5205,itpradeep2018,1,0.00377,23437,88.43817,26501
5206,itsdarshankumar,1,0.00377,23438,88.44195,26501
5207,itsMarydan,1,0.00377,23439,88.44572,26501
5208,ItsRoy69,1,0.00377,23440,88.44949,26501
5209,ivanmarquescepsa,1,0.00377,23441,88.45327,26501
5210,J0SAL,1,0.00377,23442,88.45704,26501
5211,jaBuaillon,1,0.00377,23443,88.46081,26501
5212,JacekLakis-TomTom,1,0.00377,23444,88.46459,26501
5213,jaceks2106,1,0.00377,23445,88.46836,26501
5214,Jackcrampton,1,0.00377,23446,88.47213,26501
5215,Jack-R-lantern,1,0.00377,23447,88.47591,26501
5216,jack-walters,1,0.00377,23448,88.47968,26501
5217,jacobfra,1,0.00377,23449,88.48345,26501
5218,jacobneiltaylor,1,0.00377,23450,88.48723,26501
5219,jacobnollette,1,0.00377,23451,88.49100,26501
5220,jadjay,1,0.00377,23452,88.49477,26501
5221,jae-jae,1,0.00377,23453,88.49855,26501
5222,jaemyeonglee,1,0.00377,23454,88.50232,26501
5223,jaens,1,0.00377,23455,88.50609,26501
5224,jagojar,1,0.00377,23456,88.50987,26501
5225,ja-gooding,1,0.00377,23457,88.51364,26501
5226,JaguarsCodehub,1,0.00377,23458,88.51741,26501
5227,jagu-sayan,1,0.00377,23459,88.52119,26501
5228,JakChen797,1,0.00377,23460,88.52496,26501
5229,jakemiller649,1,0.00377,23461,88.52873,26501
5230,jakeowenp,1,0.00377,23462,88.53251,26501
5231,jakeWatsonOakland,1,0.00377,23463,88.53628,26501
5232,jaki300,1,0.00377,23464,88.54006,26501
5233,jaklaassen-affirm,1,0.00377,23465,88.54383,26501
5234,jakublabno,1,0.00377,23466,88.54760,26501
5235,JalilArfaoui,1,0.00377,23467,88.55138,26501
5236,jalvespinto,1,0.00377,23468,88.55515,26501
5237,JamesCalleja,1,0.00377,23469,88.55892,26501
5238,jameshfisher,1,0.00377,23470,88.56270,26501
5239,JamesLavin,1,0.00377,23471,88.56647,26501
5240,jamesreprise,1,0.00377,23472,88.57024,26501
5241,jamestoyer,1,0.00377,23473,88.57402,26501
5242,james-trousdale-lyb,1,0.00377,23474,88.57779,26501
5243,JanCVanB,1,0.00377,23475,88.58156,26501
5244,janfuchsmann,1,0.00377,23476,88.58534,26501
5245,janheindejong,1,0.00377,23477,88.58911,26501
5246,jannavarro,1,0.00377,23478,88.59288,26501
5247,janwright73,1,0.00377,23479,88.59666,26501
5248,japareja,1,0.00377,23480,88.60043,26501
5249,japoch,1,0.00377,23481,88.60420,26501
5250,japtain-cack,1,0.00377,23482,88.60798,26501
5251,jarekdziedzic,1,0.00377,23483,88.61175,26501
5252,jaroslawporada,1,0.00377,23484,88.61552,26501
5253,jas-atwal,1,0.00377,23485,88.61930,26501
5254,JasonBourne1998,1,0.00377,23486,88.62307,26501
5255,jasonbrianhall,1,0.00377,23487,88.62684,26501
5256,Jasonhahahahaha,1,0.00377,23488,88.63062,26501
5257,Jataki,1,0.00377,23489,88.63439,26501
5258,jatinder10,1,0.00377,23490,88.63816,26501
5259,Java4all,1,0.00377,23491,88.64194,26501
5260,java-software,1,0.00377,23492,88.64571,26501
5261,javaxiaomangren,1,0.00377,23493,88.64948,26501
5262,javdrher,1,0.00377,23494,88.65326,26501
5263,jay7x,1,0.00377,23495,88.65703,26501
5264,JayEkin,1,0.00377,23496,88.66081,26501
5265,jayesh100,1,0.00377,23497,88.66458,26501
5266,jaypee-0,1,0.00377,23498,88.66835,26501
5267,jbasila-orca,1,0.00377,23499,88.67213,26501
5268,jbeemster,1,0.00377,23500,88.67590,26501
5269,jbellow,1,0.00377,23501,88.67967,26501
5270,jbongseo,1,0.00377,23502,88.68345,26501
5271,jboxman,1,0.00377,23503,88.68722,26501
5272,jbpadgett,1,0.00377,23504,88.69099,26501
5273,jbrauchlerpax8,1,0.00377,23505,88.69477,26501
5274,jbtleloup,1,0.00377,23506,88.69854,26501
5275,JBWatenbergScality,1,0.00377,23507,88.70231,26501
5276,jcheld,1,0.00377,23508,88.70609,26501
5277,JCPTrevillian,1,0.00377,23509,88.70986,26501
5278,jcurtis789,1,0.00377,23510,88.71363,26501
5279,jda258,1,0.00377,23511,88.71741,26501
5280,jdautomate,1,0.00377,23512,88.72118,26501
5281,Jdavid77,1,0.00377,23513,88.72495,26501
5282,jdavisp3,1,0.00377,23514,88.72873,26501
5283,jdepi,1,0.00377,23515,88.73250,26501
5284,jdhenke,1,0.00377,23516,88.73627,26501
5285,jdmedeiros,1,0.00377,23517,88.74005,26501
5286,jdoe91775,1,0.00377,23518,88.74382,26501
5287,JDTX0,1,0.00377,23519,88.74759,26501
5288,jeanbritz,1,0.00377,23520,88.75137,26501
5289,jeansebastienh,1,0.00377,23521,88.75514,26501
5290,jecknig,1,0.00377,23522,88.75891,26501
5291,jeehun-pas,1,0.00377,23523,88.76269,26501
5292,jeenadeepak,1,0.00377,23524,88.76646,26501
5293,jeff303,1,0.00377,23525,88.77024,26501
5294,JeffBelgum,1,0.00377,23526,88.77401,26501
5295,JeffLee1874,1,0.00377,23527,88.77778,26501
5296,jeffpuckett,1,0.00377,23528,88.78156,26501
5297,jeffwmartinez,1,0.00377,23529,88.78533,26501
5298,Jefry-nolastname,1,0.00377,23530,88.78910,26501
5299,JellyZero,1,0.00377,23531,88.79288,26501
5300,jelonka,1,0.00377,23532,88.79665,26501
5301,jennuineness,1,0.00377,23533,88.80042,26501
5302,jensjeflensje,1,0.00377,23534,88.80420,26501
5303,JenyaFTW,1,0.00377,23535,88.80797,26501
5304,JeremieDoctrine,1,0.00377,23536,88.81174,26501
5305,jeremielate,1,0.00377,23537,88.81552,26501
5306,jeremydelacruz,1,0.00377,23538,88.81929,26501
5307,jerindjoy,1,0.00377,23539,88.82306,26501
5308,jerith,1,0.00377,23540,88.82684,26501
5309,jerryhe1999,1,0.00377,23541,88.83061,26501
5310,JerryYe2020,1,0.00377,23542,88.83438,26501
5311,jesse-rusak-RTX,1,0.00377,23543,88.83816,26501
5312,jessicamarcomini,1,0.00377,23544,88.84193,26501
5313,jesuisundev,1,0.00377,23545,88.84570,26501
5314,jeyhun,1,0.00377,23546,88.84948,26501
5315,jfhenriques,1,0.00377,23547,88.85325,26501
5316,jgao1025,1,0.00377,23548,88.85702,26501
5317,jgarte,1,0.00377,23549,88.86080,26501
5318,jglogan,1,0.00377,23550,88.86457,26501
5319,jgpelaez,1,0.00377,23551,88.86834,26501
5320,jgq2008303393,1,0.00377,23552,88.87212,26501
5321,jhaabhishek115,1,0.00377,23553,88.87589,26501
5322,jhancock4d,1,0.00377,23554,88.87966,26501
5323,jhonis,1,0.00377,23555,88.88344,26501
5324,jia2118290,1,0.00377,23556,88.88721,26501
5325,jiamei-SHEN,1,0.00377,23557,88.89099,26501
5326,JianAnzx,1,0.00377,23558,88.89476,26501
5327,jiangming1,1,0.00377,23559,88.89853,26501
5328,jiankong-microsoft,1,0.00377,23560,88.90231,26501
5329,jiawen,1,0.00377,23561,88.90608,26501
5330,jimAtLoyal,1,0.00377,23562,88.90985,26501
5331,jim-bo,1,0.00377,23563,88.91363,26501
5332,jimcavoli,1,0.00377,23564,88.91740,26501
5333,jimgus,1,0.00377,23565,88.92117,26501
5334,JimmyBjorklund,1,0.00377,23566,88.92495,26501
5335,jimsmart,1,0.00377,23567,88.92872,26501
5336,jjae2124,1,0.00377,23568,88.93249,26501
5337,jjedele,1,0.00377,23569,88.93627,26501
5338,jjghali,1,0.00377,23570,88.94004,26501
5339,jjj960,1,0.00377,23571,88.94381,26501
5340,jjzazuet,1,0.00377,23572,88.94759,26501
5341,Jkaftzan,1,0.00377,23573,88.95136,26501
5342,jkamke,1,0.00377,23574,88.95513,26501
5343,jkowalleck,1,0.00377,23575,88.95891,26501
5344,jkrahn3,1,0.00377,23576,88.96268,26501
5345,jksalazar,1,0.00377,23577,88.96645,26501
5346,jlabedo,1,0.00377,23578,88.97023,26501
5347,jlkaiser,1,0.00377,23579,88.97400,26501
5348,jltvieira,1,0.00377,23580,88.97777,26501
5349,JMarji,1,0.00377,23581,88.98155,26501
5350,jmart1,1,0.00377,23582,88.98532,26501
5351,jmcx,1,0.00377,23583,88.98909,26501
5352,jmg011,1,0.00377,23584,88.99287,26501
5353,jmhodges-color,1,0.00377,23585,88.99664,26501
5354,jmk75,1,0.00377,23586,89.00042,26501
5355,jmtt89,1,0.00377,23587,89.00419,26501
5356,jnino-splunk,1,0.00377,23588,89.00796,26501
5357,jnt0r,1,0.00377,23589,89.01174,26501
5358,jnwright,1,0.00377,23590,89.01551,26501
5359,JoanFM,1,0.00377,23591,89.01928,26501
5360,joarkm1,1,0.00377,23592,89.02306,26501
5361,jocko-angi,1,0.00377,23593,89.02683,26501
5362,JoCleggAxi,1,0.00377,23594,89.03060,26501
5363,joconh,1,0.00377,23595,89.03438,26501
5364,joel0,1,0.00377,23596,89.03815,26501
5365,joelgriffiths,1,0.00377,23597,89.04192,26501
5366,Joelgullander,1,0.00377,23598,89.04570,26501
5367,JoelHaslam,1,0.00377,23599,89.04947,26501
5368,joelio,1,0.00377,23600,89.05324,26501
5369,JoelJoos,1,0.00377,23601,89.05702,26501
5370,joepvd,1,0.00377,23602,89.06079,26501
5371,johnlanda,1,0.00377,23603,89.06456,26501
5372,johnliu55-msft,1,0.00377,23604,89.06834,26501
5373,john-meeder,1,0.00377,23605,89.07211,26501
5374,johnnybubonic,1,0.00377,23606,89.07588,26501
5375,johnwangwangjun,1,0.00377,23607,89.07966,26501
5376,Jojo02905,1,0.00377,23608,89.08343,26501
5377,jolexa,1,0.00377,23609,89.08720,26501
5378,jonasbostoen,1,0.00377,23610,89.09098,26501
5379,jonasbuehrle,1,0.00377,23611,89.09475,26501
5380,jonas-hagen,1,0.00377,23612,89.09852,26501
5381,JonasPed,1,0.00377,23613,89.10230,26501
5382,jonas-wanninger,1,0.00377,23614,89.10607,26501
5383,Jonatan-V,1,0.00377,23615,89.10984,26501
5384,jonathanjsmith,1,0.00377,23616,89.11362,26501
5385,jonesy212,1,0.00377,23617,89.11739,26501
5386,jonnydee,1,0.00377,23618,89.12117,26501
5387,JoostDuisters,1,0.00377,23619,89.12494,26501
5388,JoostSaanen,1,0.00377,23620,89.12871,26501
5389,JoranLive,1,0.00377,23621,89.13249,26501
5390,jordanfelle,1,0.00377,23622,89.13626,26501
5391,jordant,1,0.00377,23623,89.14003,26501
5392,jordantshaw,1,0.00377,23624,89.14381,26501
5393,jorge-gyant,1,0.00377,23625,89.14758,26501
5394,jorgeperezc,1,0.00377,23626,89.15135,26501
5395,Jorres,1,0.00377,23627,89.15513,26501
5396,joscherrer,1,0.00377,23628,89.15890,26501
5397,joseacr,1,0.00377,23629,89.16267,26501
5398,jose-galvez,1,0.00377,23630,89.16645,26501
5399,josephcsible,1,0.00377,23631,89.17022,26501
5400,josepperna,1,0.00377,23632,89.17399,26501
5401,joshjohnson,1,0.00377,23633,89.17777,26501
5402,joshlay,1,0.00377,23634,89.18154,26501
5403,joshuagruenstein,1,0.00377,23635,89.18531,26501
5404,joshua-heidrich,1,0.00377,23636,89.18909,26501
5405,joshuakfarrar,1,0.00377,23637,89.19286,26501
5406,JoshuaWatt,1,0.00377,23638,89.19663,26501
5407,joshwright10,1,0.00377,23639,89.20041,26501
5408,JosuGZ,1,0.00377,23640,89.20418,26501
5409,jovanmilenkoski,1,0.00377,23641,89.20795,26501
5410,jpecora716,1,0.00377,23642,89.21173,26501
5411,jpgsaraceni,1,0.00377,23643,89.21550,26501
5412,jprenken,1,0.00377,23644,89.21927,26501
5413,jptux,1,0.00377,23645,89.22305,26501
5414,jregovic,1,0.00377,23646,89.22682,26501
5415,jreynard-code,1,0.00377,23647,89.23060,26501
5416,jrochette,1,0.00377,23648,89.23437,26501
5417,jroldsalmazan,1,0.00377,23649,89.23814,26501
5418,jrosiek,1,0.00377,23650,89.24192,26501
5419,jsa5593,1,0.00377,23651,89.24569,26501
5420,jsadique,1,0.00377,23652,89.24946,26501
5421,Jsalz2000,1,0.00377,23653,89.25324,26501
5422,jsamr,1,0.00377,23654,89.25701,26501
5423,jschmidt1-godaddy,1,0.00377,23655,89.26078,26501
5424,jsd2150,1,0.00377,23656,89.26456,26501
5425,jsemohub,1,0.00377,23657,89.26833,26501
5426,jsimpso,1,0.00377,23658,89.27210,26501
5427,jslatterycnvrtr,1,0.00377,23659,89.27588,26501
5428,jsmith97,1,0.00377,23660,89.27965,26501
5429,jsmith-kno2,1,0.00377,23661,89.28342,26501
5430,jsnandini09,1,0.00377,23662,89.28720,26501
5431,jstncno,1,0.00377,23663,89.29097,26501
5432,jt0dd,1,0.00377,23664,89.29474,26501
5433,jtgorny,1,0.00377,23665,89.29852,26501
5434,jt-kloudfuse,1,0.00377,23666,89.30229,26501
5435,jtmckay2017,1,0.00377,23667,89.30606,26501
5436,Jtwo-23,1,0.00377,23668,89.30984,26501
5437,ju1ianvn,1,0.00377,23669,89.31361,26501
5438,juanfbl9307,1,0.00377,23670,89.31738,26501
5439,jujubetsz,1,0.00377,23671,89.32116,26501
5440,JuliaMongo,1,0.00377,23672,89.32493,26501
5441,julianajuliano,1,0.00377,23673,89.32870,26501
5442,julian-hj,1,0.00377,23674,89.33248,26501
5443,julianobarbosa,1,0.00377,23675,89.33625,26501
5444,julien-braure,1,0.00377,23676,89.34002,26501
5445,juliusbartolome,1,0.00377,23677,89.34380,26501
5446,jun0tpyrc,1,0.00377,23678,89.34757,26501
5447,junjiexing,1,0.00377,23679,89.35135,26501
5448,juris-greitans,1,0.00377,23680,89.35512,26501
5449,Just4Ease,1,0.00377,23681,89.35889,26501
5450,justenstall,1,0.00377,23682,89.36267,26501
5451,justinjoseph89,1,0.00377,23683,89.36644,26501
5452,JustinPaulJohn,1,0.00377,23684,89.37021,26501
5453,justinrlee,1,0.00377,23685,89.37399,26501
5454,justopensrc,1,0.00377,23686,89.37776,26501
5455,juweins,1,0.00377,23687,89.38153,26501
5456,jviotti,1,0.00377,23688,89.38531,26501
5457,jwhitaker-swiftnav,1,0.00377,23689,89.38908,26501
5458,jwongo,1,0.00377,23690,89.39285,26501
5459,JWood48,1,0.00377,23691,89.39663,26501
5460,jwtrhs,1,0.00377,23692,89.40040,26501
5461,jyothiradityak,1,0.00377,23693,89.40417,26501
5462,jyothisjose,1,0.00377,23694,89.40795,26501
5463,jzaehrin,1,0.00377,23695,89.41172,26501
5464,k8sgogo,1,0.00377,23696,89.41549,26501
5465,kadler,1,0.00377,23697,89.41927,26501
5466,kailunwang-houzz,1,0.00377,23698,89.42304,26501
5467,kakserpom,1,0.00377,23699,89.42681,26501
5468,kalki-master,1,0.00377,23700,89.43059,26501
5469,kamaljit-1991,1,0.00377,23701,89.43436,26501
5470,KaMaToZzz,1,0.00377,23702,89.43813,26501
5471,kamontat,1,0.00377,23703,89.44191,26501
5472,kamzata,1,0.00377,23704,89.44568,26501
5473,KaneVV1,1,0.00377,23705,89.44945,26501
5474,kangame2000,1,0.00377,23706,89.45323,26501
5475,KannanAadhav,1,0.00377,23707,89.45700,26501
5476,kansarav,1,0.00377,23708,89.46078,26501
5477,kapcip,1,0.00377,23709,89.46455,26501
5478,karolcienkosz,1,0.00377,23710,89.46832,26501
5479,KarryZhou,1,0.00377,23711,89.47210,26501
5480,karstenmueller,1,0.00377,23712,89.47587,26501
5481,KarstenVogt,1,0.00377,23713,89.47964,26501
5482,kartikra,1,0.00377,23714,89.48342,26501
5483,kash7,1,0.00377,23715,89.48719,26501
5484,kashyap-aman-discovery,1,0.00377,23716,89.49096,26501
5485,KasperHeyndrickx,1,0.00377,23717,89.49474,26501
5486,kastland,1,0.00377,23718,89.49851,26501
5487,katehmd,1,0.00377,23719,89.50228,26501
5488,Kato129,1,0.00377,23720,89.50606,26501
5489,kaustuk,1,0.00377,23721,89.50983,26501
5490,kaustuk-samsung,1,0.00377,23722,89.51360,26501
5491,kayn1,1,0.00377,23723,89.51738,26501
5492,KazuhitoSuda-NEC,1,0.00377,23724,89.52115,26501
5493,kbabuadze,1,0.00377,23725,89.52492,26501
5494,kbriggzi,1,0.00377,23726,89.52870,26501
5495,kbzowski,1,0.00377,23727,89.53247,26501
5496,kdrag0n,1,0.00377,23728,89.53624,26501
5497,ke5C2Fin,1,0.00377,23729,89.54002,26501
5498,k-ebu,1,0.00377,23730,89.54379,26501
5499,keeky456,1,0.00377,23731,89.54756,26501
5500,KeepWannabe,1,0.00377,23732,89.55134,26501
5501,keertk,1,0.00377,23733,89.55511,26501
5502,keithkroeger,1,0.00377,23734,89.55888,26501
5503,KeltonKarboviak,1,0.00377,23735,89.56266,26501
5504,KenHuffman,1,0.00377,23736,89.56643,26501
5505,kenji21,1,0.00377,23737,89.57020,26501
5506,kennydgreat,1,0.00377,23738,89.57398,26501
5507,Kerron-Hutton,1,0.00377,23739,89.57775,26501
5508,KES777,1,0.00377,23740,89.58153,26501
5509,kesavakadiyala,1,0.00377,23741,89.58530,26501
5510,keshavy18,1,0.00377,23742,89.58907,26501
5511,kespineira,1,0.00377,23743,89.59285,26501
5512,kettlewell,1,0.00377,23744,89.59662,26501
5513,KevGoDev,1,0.00377,23745,89.60039,26501
5514,kevin-dimichel,1,0.00377,23746,89.60417,26501
5515,KevinDMack,1,0.00377,23747,89.60794,26501
5516,KevinM2k,1,0.00377,23748,89.61171,26501
5517,keyu-Li,1,0.00377,23749,89.61549,26501
5518,kgogolek,1,0.00377,23750,89.61926,26501
5519,kgopi1,1,0.00377,23751,89.62303,26501
5520,kgunnerud,1,0.00377,23752,89.62681,26501
5521,khaledrazouk,1,0.00377,23753,89.63058,26501
5522,khongSC,1,0.00377,23754,89.63435,26501
5523,KianChen,1,0.00377,23755,89.63813,26501
5524,kibblerz,1,0.00377,23756,89.64190,26501
5525,kidbai,1,0.00377,23757,89.64567,26501
5526,Kidus-berhanu,1,0.00377,23758,89.64945,26501
5527,kienvtqhi,1,0.00377,23759,89.65322,26501
5528,kikkobcn,1,0.00377,23760,89.65699,26501
5529,kilian-hu-freiheit,1,0.00377,23761,89.66077,26501
5530,Kim21tome,1,0.00377,23762,89.66454,26501
5531,KimHyunTae-95,1,0.00377,23763,89.66831,26501
5532,kimjamia,1,0.00377,23764,89.67209,26501
5533,kindkonghong,1,0.00377,23765,89.67586,26501
5534,Kingshuk-Kubera,1,0.00377,23766,89.67963,26501
5535,kingtran2112,1,0.00377,23767,89.68341,26501
5536,KiptoonKipkurui,1,0.00377,23768,89.68718,26501
5537,kirill-oficerov,1,0.00377,23769,89.69096,26501
5538,kirtisen,1,0.00377,23770,89.69473,26501
5539,kiterd2592,1,0.00377,23771,89.69850,26501
5540,kivancbilen,1,0.00377,23772,89.70228,26501
5541,kj,1,0.00377,23773,89.70605,26501
5542,kkamaldinov,1,0.00377,23774,89.70982,26501
5543,kk-bavenkatachalam,1,0.00377,23775,89.71360,26501
5544,k-kyle,1,0.00377,23776,89.71737,26501
5545,kleinpa,1,0.00377,23777,89.72114,26501
5546,Kleku81,1,0.00377,23778,89.72492,26501
5547,KlemensE,1,0.00377,23779,89.72869,26501
5548,Klochkov28,1,0.00377,23780,89.73246,26501
5549,kmcowan,1,0.00377,23781,89.73624,26501
5550,kml-mudgal,1,0.00377,23782,89.74001,26501
5551,kmorkans-lumoa,1,0.00377,23783,89.74378,26501
5552,kmunusam,1,0.00377,23784,89.74756,26501
5553,kmvachhani,1,0.00377,23785,89.75133,26501
5554,knakov-aiopsgroup,1,0.00377,23786,89.75510,26501
5555,knitmesh,1,0.00377,23787,89.75888,26501
5556,knjoroge,1,0.00377,23788,89.76265,26501
5557,knlyknly,1,0.00377,23789,89.76642,26501
5558,KnudFrandsen,1,0.00377,23790,89.77020,26501
5559,knutov,1,0.00377,23791,89.77397,26501
5560,KNZ-JP,1,0.00377,23792,89.77774,26501
5561,kobethuwis,1,0.00377,23793,89.78152,26501
5562,kobybm,1,0.00377,23794,89.78529,26501
5563,kodyssss,1,0.00377,23795,89.78906,26501
5564,kolesaev,1,0.00377,23796,89.79284,26501
5565,KolstiGG,1,0.00377,23797,89.79661,26501
5566,KongCarl,1,0.00377,23798,89.80038,26501
5567,Konkrad,1,0.00377,23799,89.80416,26501
5568,koorukuroo,1,0.00377,23800,89.80793,26501
5569,korjsh,1,0.00377,23801,89.81171,26501
5570,kostyaod,1,0.00377,23802,89.81548,26501
5571,kotlinlukas,1,0.00377,23803,89.81925,26501
5572,koullislp,1,0.00377,23804,89.82303,26501
5573,KovalchukLTD,1,0.00377,23805,89.82680,26501
5574,KovtunV,1,0.00377,23806,89.83057,26501
5575,kozart,1,0.00377,23807,89.83435,26501
5576,kposborne,1,0.00377,23808,89.83812,26501
5577,KrE80r,1,0.00377,23809,89.84189,26501
5578,krehl,1,0.00377,23810,89.84567,26501
5579,krishanshamod,1,0.00377,23811,89.84944,26501
5580,krishi0408,1,0.00377,23812,89.85321,26501
5581,KrishnaKumar-Thulasidas,1,0.00377,23813,89.85699,26501
5582,KrishnamoorthyCaucidheesan-15,1,0.00377,23814,89.86076,26501
5583,KrishnaRIG,1,0.00377,23815,89.86453,26501
5584,krismassey,1,0.00377,23816,89.86831,26501
5585,kristeey,1,0.00377,23817,89.87208,26501
5586,krisztiansala,1,0.00377,23818,89.87585,26501
5587,kroatti,1,0.00377,23819,89.87963,26501
5588,kroustou,1,0.00377,23820,89.88340,26501
5589,KR-Ravindra,1,0.00377,23821,89.88717,26501
5590,krrishkishore,1,0.00377,23822,89.89095,26501
5591,krutkoroma79911,1,0.00377,23823,89.89472,26501
5592,krvajal,1,0.00377,23824,89.89849,26501
5593,KrystianOcado,1,0.00377,23825,89.90227,26501
5594,krzee,1,0.00377,23826,89.90604,26501
5595,krzwiatrzyk,1,0.00377,23827,89.90981,26501
5596,krzyzak,1,0.00377,23828,89.91359,26501
5597,ksink7,1,0.00377,23829,89.91736,26501
5598,kstkrv,1,0.00377,23830,89.92114,26501
5599,k-takeuchi220,1,0.00377,23831,89.92491,26501
5600,ktlacaelel,1,0.00377,23832,89.92868,26501
5601,ktleung2017,1,0.00377,23833,89.93246,26501
5602,kumachop2,1,0.00377,23834,89.93623,26501
5603,KumakiriTakeo,1,0.00377,23835,89.94000,26501
5604,Kumaraditya-cardbyte,1,0.00377,23836,89.94378,26501
5605,kunreddyshyam3,1,0.00377,23837,89.94755,26501
5606,kuro96al,1,0.00377,23838,89.95132,26501
5607,Kurtcobainzl,1,0.00377,23839,89.95510,26501
5608,kurtraschke,1,0.00377,23840,89.95887,26501
5609,KurtSchenk,1,0.00377,23841,89.96264,26501
5610,kushagra-arta,1,0.00377,23842,89.96642,26501
5611,kushalg-1212,1,0.00377,23843,89.97019,26501
5612,kvmenshikov,1,0.00377,23844,89.97396,26501
5613,kvsl0,1,0.00377,23845,89.97774,26501
5614,kw510,1,0.00377,23846,89.98151,26501
5615,kyeongjun-dev,1,0.00377,23847,89.98528,26501
5616,kyryl-bogach,1,0.00377,23848,89.98906,26501
5617,kyrylo,1,0.00377,23849,89.99283,26501
5618,L0wry,1,0.00377,23850,89.99660,26501
5619,lacibus,1,0.00377,23851,90.00038,26501
5620,lafronzt,1,0.00377,23852,90.00415,26501
5621,laibruce,1,0.00377,23853,90.00792,26501
5622,LAmcpp,1,0.00377,23854,90.01170,26501
5623,LANGERGabrielle,1,0.00377,23855,90.01547,26501
5624,lanqsh,1,0.00377,23856,90.01924,26501
5625,lapete,1,0.00377,23857,90.02302,26501
5626,laserproall,1,0.00377,23858,90.02679,26501
5627,LathaRadhakrishnan,1,0.00377,23859,90.03056,26501
5628,laurynas,1,0.00377,23860,90.03434,26501
5629,Laxman-SM,1,0.00377,23861,90.03811,26501
5630,Laxmikanthkr,1,0.00377,23862,90.04189,26501
5631,Lazast,1,0.00377,23863,90.04566,26501
5632,lazovskiy,1,0.00377,23864,90.04943,26501
5633,LazyPlanet,1,0.00377,23865,90.05321,26501
5634,LazySongQ,1,0.00377,23866,90.05698,26501
5635,LBates2000,1,0.00377,23867,90.06075,26501
5636,LeadingMoominExpert,1,0.00377,23868,90.06453,26501
5637,leandrorebelo,1,0.00377,23869,90.06830,26501
5638,learningcloudk8,1,0.00377,23870,90.07207,26501
5639,LeBakii,1,0.00377,23871,90.07585,26501
5640,Lechindianer,1,0.00377,23872,90.07962,26501
5641,ledleds,1,0.00377,23873,90.08339,26501
5642,lee-haines-rft,1,0.00377,23874,90.08717,26501
5643,leejones,1,0.00377,23875,90.09094,26501
5644,leftjs,1,0.00377,23876,90.09471,26501
5645,legendik,1,0.00377,23877,90.09849,26501
5646,lemanschik,1,0.00377,23878,90.10226,26501
5647,lengcangkuganmian,1,0.00377,23879,90.10603,26501
5648,LennartAJansson,1,0.00377,23880,90.10981,26501
5649,LennieGuy,1,0.00377,23881,90.11358,26501
5650,LensHunnel,1,0.00377,23882,90.11735,26501
5651,LeoFuso,1,0.00377,23883,90.12113,26501
5652,leonatone,1,0.00377,23884,90.12490,26501
5653,leonid-lm,1,0.00377,23885,90.12867,26501
5654,Lepidopteron,1,0.00377,23886,90.13245,26501
5655,leqii-com,1,0.00377,23887,90.13622,26501
5656,leroylim20,1,0.00377,23888,90.13999,26501
5657,leshcat,1,0.00377,23889,90.14377,26501
5658,leslie110,1,0.00377,23890,90.14754,26501
5659,lespons,1,0.00377,23891,90.15132,26501
5660,letic,1,0.00377,23892,90.15509,26501
5661,letruonglamit,1,0.00377,23893,90.15886,26501
5662,levidu,1,0.00377,23894,90.16264,26501
5663,lewiseliu,1,0.00377,23895,90.16641,26501
5664,lexermal,1,0.00377,23896,90.17018,26501
5665,lflaimer,1,0.00377,23897,90.17396,26501
5666,lfranchini31,1,0.00377,23898,90.17773,26501
5667,lgenasi-gocity,1,0.00377,23899,90.18150,26501
5668,lgiedrius,1,0.00377,23900,90.18528,26501
5669,lgoebkes,1,0.00377,23901,90.18905,26501
5670,lgtminshi,1,0.00377,23902,90.19282,26501
5671,lgyhit,1,0.00377,23903,90.19660,26501
5672,liang1000,1,0.00377,23904,90.20037,26501
5673,lianjie-haozhe,1,0.00377,23905,90.20414,26501
5674,lichensky,1,0.00377,23906,90.20792,26501
5675,lightoyou,1,0.00377,23907,90.21169,26501
5676,LightVolk,1,0.00377,23908,90.21546,26501
5677,lilai23,1,0.00377,23909,90.21924,26501
5678,lilei20200726,1,0.00377,23910,90.22301,26501
5679,Limnotation,1,0.00377,23911,90.22678,26501
5680,Limsanity,1,0.00377,23912,90.23056,26501
5681,linaking-guidewire,1,0.00377,23913,90.23433,26501
5682,linczy,1,0.00377,23914,90.23810,26501
5683,linhaoyang526,1,0.00377,23915,90.24188,26501
5684,linhil,1,0.00377,23916,90.24565,26501
5685,linjicong,1,0.00377,23917,90.24942,26501
5686,linkwithsaurav,1,0.00377,23918,90.25320,26501
5687,lintai,1,0.00377,23919,90.25697,26501
5688,linzc,1,0.00377,23920,90.26074,26501
5689,Liqs-v2,1,0.00377,23921,90.26452,26501
5690,LisErb,1,0.00377,23922,90.26829,26501
5691,litded,1,0.00377,23923,90.27207,26501
5692,litios,1,0.00377,23924,90.27584,26501
5693,litongjava,1,0.00377,23925,90.27961,26501
5694,LittleMcdull,1,0.00377,23926,90.28339,26501
5695,liuao5201314,1,0.00377,23927,90.28716,26501
5696,liuxuc63,1,0.00377,23928,90.29093,26501
5697,liyancas,1,0.00377,23929,90.29471,26501
5698,Liz4187,1,0.00377,23930,90.29848,26501
5699,liz-86,1,0.00377,23931,90.30225,26501
5700,llakssz,1,0.00377,23932,90.30603,26501
5701,llwt,1,0.00377,23933,90.30980,26501
5702,LMacchi,1,0.00377,23934,90.31357,26501
5703,lnxmac,1,0.00377,23935,90.31735,26501
5704,Lobshunter86,1,0.00377,23936,90.32112,26501
5705,localden,1,0.00377,23937,90.32489,26501
5706,lockdown56,1,0.00377,23938,90.32867,26501
5707,LoicSikidi,1,0.00377,23939,90.33244,26501
5708,lokeshgahlot,1,0.00377,23940,90.33621,26501
5709,lokeshjain2008,1,0.00377,23941,90.33999,26501
5710,LomotHo,1,0.00377,23942,90.34376,26501
5711,longlei119,1,0.00377,23943,90.34753,26501
5712,LoniasGR,1,0.00377,23944,90.35131,26501
5713,looknicemm,1,0.00377,23945,90.35508,26501
5714,LookSin,1,0.00377,23946,90.35885,26501
5715,lorantalas,1,0.00377,23947,90.36263,26501
5716,lorchda,1,0.00377,23948,90.36640,26501
5717,Lorderot,1,0.00377,23949,90.37017,26501
5718,LordMsz,1,0.00377,23950,90.37395,26501
5719,lordzsolt,1,0.00377,23951,90.37772,26501
5720,LorenzoDag,1,0.00377,23952,90.38150,26501
5721,lorenzoelisio,1,0.00377,23953,90.38527,26501
5722,lorenzosciuto,1,0.00377,23954,90.38904,26501
5723,lorthirk,1,0.00377,23955,90.39282,26501
5724,loubevi,1,0.00377,23956,90.39659,26501
5725,lovuikeng,1,0.00377,23957,90.40036,26501
5726,lpanhirsch,1,0.00377,23958,90.40414,26501
5727,lpc-v,1,0.00377,23959,90.40791,26501
5728,lporras,1,0.00377,23960,90.41168,26501
5729,lptarik,1,0.00377,23961,90.41546,26501
5730,l-ra,1,0.00377,23962,90.41923,26501
5731,lsadehaan,1,0.00377,23963,90.42300,26501
5732,lshi18,1,0.00377,23964,90.42678,26501
5733,lubojr,1,0.00377,23965,90.43055,26501
5734,lucasfcnunes,1,0.00377,23966,90.43432,26501
5735,lucasfnds,1,0.00377,23967,90.43810,26501
5736,luchiniatwork,1,0.00377,23968,90.44187,26501
5737,luckqk,1,0.00377,23969,90.44564,26501
5738,lud0v1c,1,0.00377,23970,90.44942,26501
5739,luffy1947,1,0.00377,23971,90.45319,26501
5740,luis02lopez,1,0.00377,23972,90.45696,26501
5741,luiscape,1,0.00377,23973,90.46074,26501
5742,luizfbicalho,1,0.00377,23974,90.46451,26501
5743,lujakob,1,0.00377,23975,90.46828,26501
5744,lujian402356848,1,0.00377,23976,90.47206,26501
5745,lukasz-cpu,1,0.00377,23977,90.47583,26501
5746,lukaszkuczynski,1,0.00377,23978,90.47960,26501
5747,Luke20000429,1,0.00377,23979,90.48338,26501
5748,lukeqqin,1,0.00377,23980,90.48715,26501
5749,Luke-Smartnews,1,0.00377,23981,90.49092,26501
5750,luke-zhu,1,0.00377,23982,90.49470,26501
5751,Lukk17,1,0.00377,23983,90.49847,26501
5752,lunij,1,0.00377,23984,90.50225,26501
5753,luofish,1,0.00377,23985,90.50602,26501
5754,luucaocuong,1,0.00377,23986,90.50979,26501
5755,luvjoey1996,1,0.00377,23987,90.51357,26501
5756,luweiqianyi,1,0.00377,23988,90.51734,26501
5757,luxzeitlos,1,0.00377,23989,90.52111,26501
5758,luyuhuang,1,0.00377,23990,90.52489,26501
5759,lv-c-1,1,0.00377,23991,90.52866,26501
5760,lvijnck,1,0.00377,23992,90.53243,26501
5761,lykm02,1,0.00377,23993,90.53621,26501
5762,lythandas,1,0.00377,23994,90.53998,26501
5763,LZGyx,1,0.00377,23995,90.54375,26501
5764,m1t0k,1,0.00377,23996,90.54753,26501
5765,m273d15,1,0.00377,23997,90.55130,26501
5766,M4teo,1,0.00377,23998,90.55507,26501
5767,mabrikan,1,0.00377,23999,90.55885,26501
5768,MacGydver,1,0.00377,24000,90.56262,26501
5769,Maciej-Monster,1,0.00377,24001,90.56639,26501
5770,madapei,1,0.00377,24002,90.57017,26501
5771,MadbnM,1,0.00377,24003,90.57394,26501
5772,mAddmHacks,1,0.00377,24004,90.57771,26501
5773,madhubalaravi,1,0.00377,24005,90.58149,26501
5774,madi-nuralin,1,0.00377,24006,90.58526,26501
5775,Maetis,1,0.00377,24007,90.58903,26501
5776,maganap,1,0.00377,24008,90.59281,26501
5777,magicmatteo,1,0.00377,24009,90.59658,26501
5778,magsol,1,0.00377,24010,90.60035,26501
5779,mahdimo2,1,0.00377,24011,90.60413,26501
5780,mahendranbhathp,1,0.00377,24012,90.60790,26501
5781,MaheshChandrra,1,0.00377,24013,90.61168,26501
5782,Maheshvaws,1,0.00377,24014,90.61545,26501
5783,mahtin,1,0.00377,24015,90.61922,26501
5784,mahyarevafa,1,0.00377,24016,90.62300,26501
5785,majeed828,1,0.00377,24017,90.62677,26501
5786,MajidAhangari,1,0.00377,24018,90.63054,26501
5787,majidbarz,1,0.00377,24019,90.63432,26501
5788,mak241265,1,0.00377,24020,90.63809,26501
5789,Makalov1111,1,0.00377,24021,90.64186,26501
5790,makigurapo,1,0.00377,24022,90.64564,26501
5791,maksimkurb,1,0.00377,24023,90.64941,26501
5792,maksnester,1,0.00377,24024,90.65318,26501
5793,maksym-troschiy,1,0.00377,24025,90.65696,26501
5794,MalcolmCyber,1,0.00377,24026,90.66073,26501
5795,malleyali,1,0.00377,24027,90.66450,26501
5796,malon875875,1,0.00377,24028,90.66828,26501
5797,Maltawdy,1,0.00377,24029,90.67205,26501
5798,mango009,1,0.00377,24030,90.67582,26501
5799,manhattaner,1,0.00377,24031,90.67960,26501
5800,manisha5464,1,0.00377,24032,90.68337,26501
5801,manish-agrawal-ai,1,0.00377,24033,90.68714,26501
5802,Manishpandey11,1,0.00377,24034,90.69092,26501
5803,Manoharan-NMS,1,0.00377,24035,90.69469,26501
5804,manojmohandas14,1,0.00377,24036,90.69846,26501
5805,mansisingla89,1,0.00377,24037,90.70224,26501
5806,manster18,1,0.00377,24038,90.70601,26501
5807,manthram,1,0.00377,24039,90.70978,26501
5808,manu-vaillant-afk,1,0.00377,24040,90.71356,26501
5809,marblerun,1,0.00377,24041,90.71733,26501
5810,marcelbenz,1,0.00377,24042,90.72110,26501
5811,marcelk-workstreampeople-com,1,0.00377,24043,90.72488,26501
5812,marcelmindemann,1,0.00377,24044,90.72865,26501
5813,marcelo-medeiros,1,0.00377,24045,90.73243,26501
5814,MarceloPeresToi,1,0.00377,24046,90.73620,26501
5815,marcelosauter,1,0.00377,24047,90.73997,26501
5816,Marcin250,1,0.00377,24048,90.74375,26501
5817,MarcinGrinberg,1,0.00377,24049,90.74752,26501
5818,MarcinNowak-codes,1,0.00377,24050,90.75129,26501
5819,marcinsiennicki95,1,0.00377,24051,90.75507,26501
5820,marcoferri72,1,0.00377,24052,90.75884,26501
5821,marcowuethrich,1,0.00377,24053,90.76261,26501
5822,marculsi,1,0.00377,24054,90.76639,26501
5823,Marcus10110,1,0.00377,24055,90.77016,26501
5824,marcusit,1,0.00377,24056,90.77393,26501
5825,mardi2020,1,0.00377,24057,90.77771,26501
5826,marek22k,1,0.00377,24058,90.78148,26501
5827,marekciel,1,0.00377,24059,90.78525,26501
5828,margelatu,1,0.00377,24060,90.78903,26501
5829,mariadb-MihailMihaylov,1,0.00377,24061,90.79280,26501
5830,marianheinsen,1,0.00377,24062,90.79657,26501
5831,marinasundstrom,1,0.00377,24063,90.80035,26501
5832,markkhosla,1,0.00377,24064,90.80412,26501
5833,MarkOStewart,1,0.00377,24065,90.80789,26501
5834,MarkProminic,1,0.00377,24066,90.81167,26501
5835,mark-reidman-intel,1,0.00377,24067,90.81544,26501
5836,MarkusAchenbach,1,0.00377,24068,90.81921,26501
5837,MarkusBauerFS,1,0.00377,24069,90.82299,26501
5838,markusdumke,1,0.00377,24070,90.82676,26501
5839,markyjones,1,0.00377,24071,90.83053,26501
5840,marrws,1,0.00377,24072,90.83431,26501
5841,MarshallBelles,1,0.00377,24073,90.83808,26501
5842,martencassel,1,0.00377,24074,90.84186,26501
5843,martinelli-francesco,1,0.00377,24075,90.84563,26501
5844,martingbrown,1,0.00377,24076,90.84940,26501
5845,martinlinkhorst-urbit,1,0.00377,24077,90.85318,26501
5846,martinnirtl,1,0.00377,24078,90.85695,26501
5847,MartinSchmidt,1,0.00377,24079,90.86072,26501
5848,martinwbw,1,0.00377,24080,90.86450,26501
5849,Marudhas,1,0.00377,24081,90.86827,26501
5850,maruf210,1,0.00377,24082,90.87204,26501
5851,maruno,1,0.00377,24083,90.87582,26501
5852,masadaco,1,0.00377,24084,90.87959,26501
5853,mashitu,1,0.00377,24085,90.88336,26501
5854,masonyc,1,0.00377,24086,90.88714,26501
5855,masrur2022,1,0.00377,24087,90.89091,26501
5856,mass-im,1,0.00377,24088,90.89468,26501
5857,massimovec,1,0.00377,24089,90.89846,26501
5858,masterashu-motorq,1,0.00377,24090,90.90223,26501
5859,MateuszMiekicki,1,0.00377,24091,90.90600,26501
5860,MatheusGeiger,1,0.00377,24092,90.90978,26501
5861,matheus-rossi,1,0.00377,24093,90.91355,26501
5862,mathijsfr,1,0.00377,24094,90.91732,26501
5863,mathumohan25,1,0.00377,24095,90.92110,26501
5864,mathus13,1,0.00377,24096,90.92487,26501
5865,matiasgarciaisaia,1,0.00377,24097,90.92864,26501
5866,matiaslareo,1,0.00377,24098,90.93242,26501
5867,mattbhenley,1,0.00377,24099,90.93619,26501
5868,MatthewCane,1,0.00377,24100,90.93996,26501
5869,matthew-ellis,1,0.00377,24101,90.94374,26501
5870,MatthewJSalerno,1,0.00377,24102,90.94751,26501
5871,matthewtorr-msft,1,0.00377,24103,90.95128,26501
5872,MatthiasWerning,1,0.00377,24104,90.95506,26501
5873,matthijsvanderloos,1,0.00377,24105,90.95883,26501
5874,mattiaorsi,1,0.00377,24106,90.96261,26501
5875,mattj150,1,0.00377,24107,90.96638,26501
5876,mattmadeofpasta,1,0.00377,24108,90.97015,26501
5877,mattselkey,1,0.00377,24109,90.97393,26501
5878,MattSilvaa,1,0.00377,24110,90.97770,26501
5879,maucrvlh,1,0.00377,24111,90.98147,26501
5880,max-ch-88,1,0.00377,24112,90.98525,26501
5881,MaxClercEricsson,1,0.00377,24113,90.98902,26501
5882,maxemann96,1,0.00377,24114,90.99279,26501
5883,Maxersh,1,0.00377,24115,90.99657,26501
5884,MaxG87,1,0.00377,24116,91.00034,26501
5885,maxkuangsy,1,0.00377,24117,91.00411,26501
5886,maxmillssb,1,0.00377,24118,91.00789,26501
5887,maxmindlin,1,0.00377,24119,91.01166,26501
5888,maxsargentdev,1,0.00377,24120,91.01543,26501
5889,maxxibon,1,0.00377,24121,91.01921,26501
5890,Mayaleeeee,1,0.00377,24122,91.02298,26501
5891,MazArslan,1,0.00377,24123,91.02675,26501
5892,Mazhenglong,1,0.00377,24124,91.03053,26501
5893,mbalous,1,0.00377,24125,91.03430,26501
5894,mblixter,1,0.00377,24126,91.03807,26501
5895,mbrizbee,1,0.00377,24127,91.04185,26501
5896,mbrownnycnyc,1,0.00377,24128,91.04562,26501
5897,mcarajatchawla,1,0.00377,24129,91.04939,26501
5898,mccok,1,0.00377,24130,91.05317,26501
5899,mchamlee,1,0.00377,24131,91.05694,26501
5900,mcollins-ttd,1,0.00377,24132,91.06071,26501
5901,mdalgitsis,1,0.00377,24133,91.06449,26501
5902,mdantonio,1,0.00377,24134,91.06826,26501
5903,Md-Sadaf,1,0.00377,24135,91.07204,26501
5904,mechanicalbot,1,0.00377,24136,91.07581,26501
5905,medicol69,1,0.00377,24137,91.07958,26501
5906,medvec-martin,1,0.00377,24138,91.08336,26501
5907,meeksOreilly,1,0.00377,24139,91.08713,26501
5908,mehak08g,1,0.00377,24140,91.09090,26501
5909,mehtamanan,1,0.00377,24141,91.09468,26501
5910,Melbink,1,0.00377,24142,91.09845,26501
5911,melianim23,1,0.00377,24143,91.10222,26501
5912,melikesozeri,1,0.00377,24144,91.10600,26501
5913,melkishengue,1,0.00377,24145,91.10977,26501
5914,mengsuenyan,1,0.00377,24146,91.11354,26501
5915,meramagic,1,0.00377,24147,91.11732,26501
5916,Merrick28,1,0.00377,24148,91.12109,26501
5917,metadeng,1,0.00377,24149,91.12486,26501
5918,metanull-operator,1,0.00377,24150,91.12864,26501
5919,metzgertie,1,0.00377,24151,91.13241,26501
5920,mfahrul,1,0.00377,24152,91.13618,26501
5921,mfarahy,1,0.00377,24153,91.13996,26501
5922,Mfonn,1,0.00377,24154,91.14373,26501
5923,mfractal,1,0.00377,24155,91.14750,26501
5924,mFranz82,1,0.00377,24156,91.15128,26501
5925,mfruhner,1,0.00377,24157,91.15505,26501
5926,mfs-gonzalo-lazaro,1,0.00377,24158,91.15882,26501
5927,mgacamedica,1,0.00377,24159,91.16260,26501
5928,mhagnumdw,1,0.00377,24160,91.16637,26501
5929,mharrvic,1,0.00377,24161,91.17014,26501
5930,mhassaankhokhar,1,0.00377,24162,91.17392,26501
5931,mhawarneh,1,0.00377,24163,91.17769,26501
5932,mheiges,1,0.00377,24164,91.18146,26501
5933,mhermosi,1,0.00377,24165,91.18524,26501
5934,mhmdunl1,1,0.00377,24166,91.18901,26501
5935,mhonorio,1,0.00377,24167,91.19279,26501
5936,m-ibrahim-y42,1,0.00377,24168,91.19656,26501
5937,micaelmbagira,1,0.00377,24169,91.20033,26501
5938,micatlkw,1,0.00377,24170,91.20411,26501
5939,Michal-lolo,1,0.00377,24171,91.20788,26501
5940,michalpaukert,1,0.00377,24172,91.21165,26501
5941,MichalZalecki,1,0.00377,24173,91.21543,26501
5942,michdim,1,0.00377,24174,91.21920,26501
5943,michelec1000,1,0.00377,24175,91.22297,26501
5944,michelkaeser,1,0.00377,24176,91.22675,26501
5945,michelson,1,0.00377,24177,91.23052,26501
5946,michoello,1,0.00377,24178,91.23429,26501
5947,mickeyzzc,1,0.00377,24179,91.23807,26501
5948,micmel5997,1,0.00377,24180,91.24184,26501
5949,midnightcodr,1,0.00377,24181,91.24561,26501
5950,midorifizz,1,0.00377,24182,91.24939,26501
5951,migarciaduran,1,0.00377,24183,91.25316,26501
5952,MiGrandjean,1,0.00377,24184,91.25693,26501
5953,mihir-koyaltech,1,0.00377,24185,91.26071,26501
5954,mihn,1,0.00377,24186,91.26448,26501
5955,mikakatua,1,0.00377,24187,91.26825,26501
5956,mike26377,1,0.00377,24188,91.27203,26501
5957,mike-baker-on,1,0.00377,24189,91.27580,26501
5958,mike-chen-samsung,1,0.00377,24190,91.27957,26501
5959,MikeDevresse,1,0.00377,24191,91.28335,26501
5960,Mike-Dunton,1,0.00377,24192,91.28712,26501
5961,MikeFindsThings,1,0.00377,24193,91.29089,26501
5962,mikeh89,1,0.00377,24194,91.29467,26501
5963,mike-larson,1,0.00377,24195,91.29844,26501
5964,mikeldking,1,0.00377,24196,91.30222,26501
5965,MikeRiz521,1,0.00377,24197,91.30599,26501
5966,miketoupin,1,0.00377,24198,91.30976,26501
5967,mikhael28,1,0.00377,24199,91.31354,26501
5968,miki725,1,0.00377,24200,91.31731,26501
5969,mikkelblanne,1,0.00377,24201,91.32108,26501
5970,mikocot,1,0.00377,24202,91.32486,26501
5971,mile-misan,1,0.00377,24203,91.32863,26501
5972,MinliangLin,1,0.00377,24204,91.33240,26501
5973,minnat65,1,0.00377,24205,91.33618,26501
5974,miospruit,1,0.00377,24206,91.33995,26501
5975,miroslav-staffa,1,0.00377,24207,91.34372,26501
5976,mishnz,1,0.00377,24208,91.34750,26501
5977,Mistikan,1,0.00377,24209,91.35127,26501
5978,mitchross,1,0.00377,24210,91.35504,26501
5979,mitech11,1,0.00377,24211,91.35882,26501
5980,miyamotokenji,1,0.00377,24212,91.36259,26501
5981,mizzack,1,0.00377,24213,91.36636,26501
5982,mjacksonest,1,0.00377,24214,91.37014,26501
5983,mjekrami,1,0.00377,24215,91.37391,26501
5984,mjgrzybek,1,0.00377,24216,91.37768,26501
5985,mjroeleveld,1,0.00377,24217,91.38146,26501
5986,mjsprojects,1,0.00377,24218,91.38523,26501
5987,MkAnHui,1,0.00377,24219,91.38900,26501
5988,mkgvb,1,0.00377,24220,91.39278,26501
5989,mkirouac,1,0.00377,24221,91.39655,26501
5990,mkjensen,1,0.00377,24222,91.40032,26501
5991,MKnichal,1,0.00377,24223,91.40410,26501
5992,mkoreneff,1,0.00377,24224,91.40787,26501
5993,mkurimeti,1,0.00377,24225,91.41164,26501
5994,mlappo,1,0.00377,24226,91.41542,26501
5995,MMA17,1,0.00377,24227,91.41919,26501
5996,mmacdonald86,1,0.00377,24228,91.42297,26501
5997,mmartinalo,1,0.00377,24229,91.42674,26501
5998,mmattel,1,0.00377,24230,91.43051,26501
5999,mmcshaffry,1,0.00377,24231,91.43429,26501
6000,mmjp-rusty,1,0.00377,24232,91.43806,26501
6001,mmralser,1,0.00377,24233,91.44183,26501
6002,mmzip01,1,0.00377,24234,91.44561,26501
6003,moaismario,1,0.00377,24235,91.44938,26501
6004,m-ocean-it,1,0.00377,24236,91.45315,26501
6005,modassarrana89,1,0.00377,24237,91.45693,26501
6006,modigithub,1,0.00377,24238,91.46070,26501
6007,modosc,1,0.00377,24239,91.46447,26501
6008,modulitos,1,0.00377,24240,91.46825,26501
6009,MoElaSec,1,0.00377,24241,91.47202,26501
6010,moeshinyo,1,0.00377,24242,91.47579,26501
6011,Mohamed2assem,1,0.00377,24243,91.47957,26501
6012,mohamedhani,1,0.00377,24244,91.48334,26501
6013,MohamedKasem99,1,0.00377,24245,91.48711,26501
6014,mohe2015,1,0.00377,24246,91.49089,26501
6015,mohit1607,1,0.00377,24247,91.49466,26501
6016,mohithm2,1,0.00377,24248,91.49843,26501
6017,mohitvdx,1,0.00377,24249,91.50221,26501
6018,MohsenNz,1,0.00377,24250,91.50598,26501
6019,mojtaba-naseri,1,0.00377,24251,91.50975,26501
6020,mokaton,1,0.00377,24252,91.51353,26501
6021,monachi,1,0.00377,24253,91.51730,26501
6022,Moneshs,1,0.00377,24254,91.52107,26501
6023,mongoDynamo,1,0.00377,24255,91.52485,26501
6024,Monitob,1,0.00377,24256,91.52862,26501
6025,monokles,1,0.00377,24257,91.53240,26501
6026,mooky31,1,0.00377,24258,91.53617,26501
6027,MoonChel,1,0.00377,24259,91.53994,26501
6028,mooneym17,1,0.00377,24260,91.54372,26501
6029,moonnoon,1,0.00377,24261,91.54749,26501
6030,mopp,1,0.00377,24262,91.55126,26501
6031,moranw85,1,0.00377,24263,91.55504,26501
6032,mor-benhamo,1,0.00377,24264,91.55881,26501
6033,moreinhardt,1,0.00377,24265,91.56258,26501
6034,moreyog,1,0.00377,24266,91.56636,26501
6035,morningman,1,0.00377,24267,91.57013,26501
6036,morrissimo,1,0.00377,24268,91.57390,26501
6037,mortrick,1,0.00377,24269,91.57768,26501
6038,morya,1,0.00377,24270,91.58145,26501
6039,MoSehsah,1,0.00377,24271,91.58522,26501
6040,Mossjiang,1,0.00377,24272,91.58900,26501
6041,motevets,1,0.00377,24273,91.59277,26501
6042,mountain65,1,0.00377,24274,91.59654,26501
6043,MountComb,1,0.00377,24275,91.60032,26501
6044,MousaZeidBaker,1,0.00377,24276,91.60409,26501
6045,mpanowicz,1,0.00377,24277,91.60786,26501
6046,mparrade,1,0.00377,24278,91.61164,26501
6047,mparram,1,0.00377,24279,91.61541,26501
6048,mponss,1,0.00377,24280,91.61918,26501
6049,mpriscella,1,0.00377,24281,91.62296,26501
6050,mradyd918,1,0.00377,24282,91.62673,26501
6051,mrajus02,1,0.00377,24283,91.63050,26501
6052,Mrchumo,1,0.00377,24284,91.63428,26501
6053,mr-coveros,1,0.00377,24285,91.63805,26501
6054,mrfoulds,1,0.00377,24286,91.64182,26501
6055,MrGold-GoldMedia-gmail-com,1,0.00377,24287,91.64560,26501
6056,mrhamburg,1,0.00377,24288,91.64937,26501
6057,mrj0,1,0.00377,24289,91.65315,26501
6058,mrmadira,1,0.00377,24290,91.65692,26501
6059,MrMarkW,1,0.00377,24291,91.66069,26501
6060,MrOnlineCoder,1,0.00377,24292,91.66447,26501
6061,mr-pascal,1,0.00377,24293,91.66824,26501
6062,mrpopogod,1,0.00377,24294,91.67201,26501
6063,Mr-Rain,1,0.00377,24295,91.67579,26501
6064,mrtnd,1,0.00377,24296,91.67956,26501
6065,mrtworo,1,0.00377,24297,91.68333,26501
6066,msalman899,1,0.00377,24298,91.68711,26501
6067,msameen4,1,0.00377,24299,91.69088,26501
6068,msgilligan,1,0.00377,24300,91.69465,26501
6069,msguit,1,0.00377,24301,91.69843,26501
6070,MShekow,1,0.00377,24302,91.70220,26501
6071,mslearner,1,0.00377,24303,91.70597,26501
6072,msotoperdomo,1,0.00377,24304,91.70975,26501
6073,mspdt22,1,0.00377,24305,91.71352,26501
6074,mstatv,1,0.00377,24306,91.71729,26501
6075,mstruser,1,0.00377,24307,91.72107,26501
6076,mtasaka,1,0.00377,24308,91.72484,26501
6077,mtkk-hara,1,0.00377,24309,91.72861,26501
6078,mt-milind,1,0.00377,24310,91.73239,26501
6079,mtraynham,1,0.00377,24311,91.73616,26501
6080,Muamaidbengt,1,0.00377,24312,91.73993,26501
6081,muattiyah,1,0.00377,24313,91.74371,26501
6082,Mubangizi,1,0.00377,24314,91.74748,26501
6083,mucahitkantepe,1,0.00377,24315,91.75125,26501
6084,mudassirsyed39,1,0.00377,24316,91.75503,26501
6085,MuhammadAliYousaf,1,0.00377,24317,91.75880,26501
6086,Muhammadh1994,1,0.00377,24318,91.76257,26501
6087,Muhammad-Sohrab,1,0.00377,24319,91.76635,26501
6088,mujinhuakai,1,0.00377,24320,91.77012,26501
6089,mukundparmar,1,0.00377,24321,91.77390,26501
6090,mukundrv,1,0.00377,24322,91.77767,26501
6091,munenek,1,0.00377,24323,91.78144,26501
6092,munikera,1,0.00377,24324,91.78522,26501
6093,mupjha,1,0.00377,24325,91.78899,26501
6094,musheriff,1,0.00377,24326,91.79276,26501
6095,mustafaabasaran,1,0.00377,24327,91.79654,26501
6096,m-wcislo,1,0.00377,24328,91.80031,26501
6097,mwittig,1,0.00377,24329,91.80408,26501
6098,mxmathieu,1,0.00377,24330,91.80786,26501
6099,MyCADDev,1,0.00377,24331,91.81163,26501
6100,MyCodel,1,0.00377,24332,91.81540,26501
6101,mydoomfr,1,0.00377,24333,91.81918,26501
6102,myevit,1,0.00377,24334,91.82295,26501
6103,my-janala,1,0.00377,24335,91.82672,26501
6104,mykhailo-b,1,0.00377,24336,91.83050,26501
6105,myleo1,1,0.00377,24337,91.83427,26501
6106,mynkkmr,1,0.00377,24338,91.83804,26501
6107,mzeeshan1,1,0.00377,24339,91.84182,26501
6108,MzoroHaHa,1,0.00377,24340,91.84559,26501
6109,N0mansky,1,0.00377,24341,91.84936,26501
6110,nabeelshaikh7,1,0.00377,24342,91.85314,26501
6111,NabilusT,1,0.00377,24343,91.85691,26501
6112,nacerkraa,1,0.00377,24344,91.86068,26501
6113,nadavgolden,1,0.00377,24345,91.86446,26501
6114,Nadavpe,1,0.00377,24346,91.86823,26501
6115,nadavSalman,1,0.00377,24347,91.87200,26501
6116,nadavwe,1,0.00377,24348,91.87578,26501
6117,nadellavamsee,1,0.00377,24349,91.87955,26501
6118,Naewis,1,0.00377,24350,91.88333,26501
6119,nagaraj-pattar,1,0.00377,24351,91.88710,26501
6120,NagarajSundaramahalingam,1,0.00377,24352,91.89087,26501
6121,nagavijayan-nagarathinam,1,0.00377,24353,91.89465,26501
6122,naimetti,1,0.00377,24354,91.89842,26501
6123,NakulJain-git,1,0.00377,24355,91.90219,26501
6124,nanderson94,1,0.00377,24356,91.90597,26501
6125,naquin,1,0.00377,24357,91.90974,26501
6126,narendrapatel,1,0.00377,24358,91.91351,26501
6127,narmendariz,1,0.00377,24359,91.91729,26501
6128,naru014,1,0.00377,24360,91.92106,26501
6129,narunas-vay,1,0.00377,24361,91.92483,26501
6130,nashley,1,0.00377,24362,91.92861,26501
6131,nashton,1,0.00377,24363,91.93238,26501
6132,nasir9622,1,0.00377,24364,91.93615,26501
6133,NateRoiger,1,0.00377,24365,91.93993,26501
6134,nation-lucas,1,0.00377,24366,91.94370,26501
6135,nat-leo,1,0.00377,24367,91.94747,26501
6136,nattvasan,1,0.00377,24368,91.95125,26501
6137,NauqGnesh,1,0.00377,24369,91.95502,26501
6138,naveen-chakrapani,1,0.00377,24370,91.95879,26501
6139,NaveLevi,1,0.00377,24371,91.96257,26501
6140,navinag1989,1,0.00377,24372,91.96634,26501
6141,na-wu,1,0.00377,24373,91.97011,26501
6142,nbabanov,1,0.00377,24374,91.97389,26501
6143,nbatchelder,1,0.00377,24375,91.97766,26501
6144,nbrns,1,0.00377,24376,91.98143,26501
6145,nc-gcz,1,0.00377,24377,91.98521,26501
6146,ncgisudo,1,0.00377,24378,91.98898,26501
6147,nclr,1,0.00377,24379,91.99275,26501
6148,NCRonB,1,0.00377,24380,91.99653,26501
6149,ndkhangvl,1,0.00377,24381,92.00030,26501
6150,nduc4nh,1,0.00377,24382,92.00408,26501
6151,neeldview,1,0.00377,24383,92.00785,26501
6152,neeraj-ec,1,0.00377,24384,92.01162,26501
6153,neerajg5,1,0.00377,24385,92.01540,26501
6154,neeta-rathi,1,0.00377,24386,92.01917,26501
6155,negtak,1,0.00377,24387,92.02294,26501
6156,nehashet92,1,0.00377,24388,92.02672,26501
6157,NeilJ12,1,0.00377,24389,92.03049,26501
6158,neilprosser,1,0.00377,24390,92.03426,26501
6159,neitrinoweb,1,0.00377,24391,92.03804,26501
6160,neitzj,1,0.00377,24392,92.04181,26501
6161,nelisbijl,1,0.00377,24393,92.04558,26501
6162,nellyk,1,0.00377,24394,92.04936,26501
6163,nelsontleidos,1,0.00377,24395,92.05313,26501
6164,nephilimboy,1,0.00377,24396,92.05690,26501
6165,nerdoc,1,0.00377,24397,92.06068,26501
6166,nerdynick,1,0.00377,24398,92.06445,26501
6167,Nero22k,1,0.00377,24399,92.06822,26501
6168,neron-traice,1,0.00377,24400,92.07200,26501
6169,nessa829,1,0.00377,24401,92.07577,26501
6170,netturpin,1,0.00377,24402,92.07954,26501
6171,NeutrinoXY,1,0.00377,24403,92.08332,26501
6172,neuxs,1,0.00377,24404,92.08709,26501
6173,neverbeenthisweeb,1,0.00377,24405,92.09086,26501
6174,Nevin1901,1,0.00377,24406,92.09464,26501
6175,nevivurn,1,0.00377,24407,92.09841,26501
6176,nevotz,1,0.00377,24408,92.10218,26501
6177,newtechies,1,0.00377,24409,92.10596,26501
6178,nextauthn,1,0.00377,24410,92.10973,26501
6179,nexus2204,1,0.00377,24411,92.11351,26501
6180,nfrik,1,0.00377,24412,92.11728,26501
6181,ngangadhar-pki,1,0.00377,24413,92.12105,26501
6182,ngoral,1,0.00377,24414,92.12483,26501
6183,nguyenviet04,1,0.00377,24415,92.12860,26501
6184,nhaancs,1,0.00377,24416,92.13237,26501
6185,nhnam6,1,0.00377,24417,92.13615,26501
6186,niallminer,1,0.00377,24418,92.13992,26501
6187,nibrahv,1,0.00377,24419,92.14369,26501
6188,nick-cerebras,1,0.00377,24420,92.14747,26501
6189,nickdine,1,0.00377,24421,92.15124,26501
6190,nickeeex,1,0.00377,24422,92.15501,26501
6191,nickzxing,1,0.00377,24423,92.15879,26501
6192,nicocout,1,0.00377,24424,92.16256,26501
6193,nicofff,1,0.00377,24425,92.16633,26501
6194,NicolasFelippe,1,0.00377,24426,92.17011,26501
6195,NicolasGras,1,0.00377,24427,92.17388,26501
6196,nicolasholanda,1,0.00377,24428,92.17765,26501
6197,nicolasmafraintelipost,1,0.00377,24429,92.18143,26501
6198,NicolasTobias,1,0.00377,24430,92.18520,26501
6199,nicollet,1,0.00377,24431,92.18897,26501
6200,nics90,1,0.00377,24432,92.19275,26501
6201,niekvb,1,0.00377,24433,92.19652,26501
6202,nikhil1011,1,0.00377,24434,92.20029,26501
6203,nikhilthakre,1,0.00377,24435,92.20407,26501
6204,nikitakogan1,1,0.00377,24436,92.20784,26501
6205,nilabjasarkar123,1,0.00377,24437,92.21161,26501
6206,nimblenitin,1,0.00377,24438,92.21539,26501
6207,Ninassl,1,0.00377,24439,92.21916,26501
6208,ningan123,1,0.00377,24440,92.22293,26501
6209,ninghejun,1,0.00377,24441,92.22671,26501
6210,ninthflavors,1,0.00377,24442,92.23048,26501
6211,nis130,1,0.00377,24443,92.23426,26501
6212,nisanthreddy,1,0.00377,24444,92.23803,26501
6213,nishantn3,1,0.00377,24445,92.24180,26501
6214,nitin992vij,1,0.00377,24446,92.24558,26501
6215,nitinchavan01,1,0.00377,24447,92.24935,26501
6216,nitinjagjivan,1,0.00377,24448,92.25312,26501
6217,NivEz,1,0.00377,24449,92.25690,26501
6218,nktener0902,1,0.00377,24450,92.26067,26501
6219,nlvw,1,0.00377,24451,92.26444,26501
6220,nmadhavi33,1,0.00377,24452,92.26822,26501
6221,nmarchini,1,0.00377,24453,92.27199,26501
6222,nmarukovich,1,0.00377,24454,92.27576,26501
6223,nm-pictelai,1,0.00377,24455,92.27954,26501
6224,NOBLES5E,1,0.00377,24456,92.28331,26501
6225,node17,1,0.00377,24457,92.28708,26501
6226,nomadaryan,1,0.00377,24458,92.29086,26501
6227,noryev,1,0.00377,24459,92.29463,26501
6228,nosas,1,0.00377,24460,92.29840,26501
6229,notdodo,1,0.00377,24461,92.30218,26501
6230,notniknot,1,0.00377,24462,92.30595,26501
6231,notnmeyer,1,0.00377,24463,92.30972,26501
6232,nouxf,1,0.00377,24464,92.31350,26501
6233,novahow,1,0.00377,24465,92.31727,26501
6234,novascreen,1,0.00377,24466,92.32104,26501
6235,novneet03,1,0.00377,24467,92.32482,26501
6236,novski,1,0.00377,24468,92.32859,26501
6237,npellegrin,1,0.00377,24469,92.33236,26501
6238,NPhGit,1,0.00377,24470,92.33614,26501
6239,nrudnyk,1,0.00377,24471,92.33991,26501
6240,nshiveg,1,0.00377,24472,92.34369,26501
6241,nt-7,1,0.00377,24473,92.34746,26501
6242,ntns,1,0.00377,24474,92.35123,26501
6243,nujragan,1,0.00377,24475,92.35501,26501
6244,nuwansa,1,0.00377,24476,92.35878,26501
6245,nvmmax,1,0.00377,24477,92.36255,26501
6246,nwebb11,1,0.00377,24478,92.36633,26501
6247,nwpuCfy,1,0.00377,24479,92.37010,26501
6248,nxc933,1,0.00377,24480,92.37387,26501
6249,nxtcoder17,1,0.00377,24481,92.37765,26501
6250,Nyantechnolog,1,0.00377,24482,92.38142,26501
6251,NyCodeGHG,1,0.00377,24483,92.38519,26501
6252,o10s,1,0.00377,24484,92.38897,26501
6253,oamontemayor,1,0.00377,24485,92.39274,26501
6254,obecker,1,0.00377,24486,92.39651,26501
6255,obiTrinobiIntel,1,0.00377,24487,92.40029,26501
6256,octo47,1,0.00377,24488,92.40406,26501
6257,oculos,1,0.00377,24489,92.40783,26501
6258,odbaeu,1,0.00377,24490,92.41161,26501
6259,oDevArc,1,0.00377,24491,92.41538,26501
6260,oetiker,1,0.00377,24492,92.41915,26501
6261,oeui,1,0.00377,24493,92.42293,26501
6262,oferziss-armis,1,0.00377,24494,92.42670,26501
6263,ognjengrubac-tomtom,1,0.00377,24495,92.43047,26501
6264,Oicho,1,0.00377,24496,92.43425,26501
6265,olafranzen10,1,0.00377,24497,92.43802,26501
6266,olane,1,0.00377,24498,92.44179,26501
6267,olcuhu,1,0.00377,24499,92.44557,26501
6268,oleeander,1,0.00377,24500,92.44934,26501
6269,oleksandrtroshyn,1,0.00377,24501,92.45311,26501
6270,Oli945,1,0.00377,24502,92.45689,26501
6271,Olical22,1,0.00377,24503,92.46066,26501
6272,oliveers,1,0.00377,24504,92.46444,26501
6273,oliver-ni,1,0.00377,24505,92.46821,26501
6274,olivernybroe,1,0.00377,24506,92.47198,26501
6275,OlivierJavaux,1,0.00377,24507,92.47576,26501
6276,ollid2405,1,0.00377,24508,92.47953,26501
6277,Olof-IL,1,0.00377,24509,92.48330,26501
6278,olumayor99,1,0.00377,24510,92.48708,26501
6279,omeinderink,1,0.00377,24511,92.49085,26501
6280,omgirok,1,0.00377,24512,92.49462,26501
6281,omkarade,1,0.00377,24513,92.49840,26501
6282,omris94,1,0.00377,24514,92.50217,26501
6283,omrishilton,1,0.00377,24515,92.50594,26501
6284,onderilkesever,1,0.00377,24516,92.50972,26501
6285,ondra-novak,1,0.00377,24517,92.51349,26501
6286,ondrejsika,1,0.00377,24518,92.51726,26501
6287,onelaview,1,0.00377,24519,92.52104,26501
6288,onelcat,1,0.00377,24520,92.52481,26501
6289,onepiece010938,1,0.00377,24521,92.52858,26501
6290,one-smart,1,0.00377,24522,92.53236,26501
6291,one-the,1,0.00377,24523,92.53613,26501
6292,oni-oni-oni-1,1,0.00377,24524,92.53990,26501
6293,onlinebaba,1,0.00377,24525,92.54368,26501
6294,openqt,1,0.00377,24526,92.54745,26501
6295,OperationalFallacy,1,0.00377,24527,92.55122,26501
6296,oranintelliflo,1,0.00377,24528,92.55500,26501
6297,OrBin,1,0.00377,24529,92.55877,26501
6298,OrenZhang,1,0.00377,24530,92.56254,26501
6299,orest-gulman,1,0.00377,24531,92.56632,26501
6300,org-ci-cd,1,0.00377,24532,92.57009,26501
6301,orian12173,1,0.00377,24533,92.57387,26501
6302,orionpretty,1,0.00377,24534,92.57764,26501
6303,OrlinVasilevTest,1,0.00377,24535,92.58141,26501
6304,Osazz,1,0.00377,24536,92.58519,26501
6305,oscaracena,1,0.00377,24537,92.58896,26501
6306,oscarsix,1,0.00377,24538,92.59273,26501
6307,OscartGiles,1,0.00377,24539,92.59651,26501
6308,OscBacon,1,0.00377,24540,92.60028,26501
6309,osier,1,0.00377,24541,92.60405,26501
6310,osnabrugge,1,0.00377,24542,92.60783,26501
6311,otischan,1,0.00377,24543,92.61160,26501
6312,otto-gebb,1,0.00377,24544,92.61537,26501
6313,otto-joe,1,0.00377,24545,92.61915,26501
6314,OUCzhangzheng,1,0.00377,24546,92.62292,26501
6315,oukian,1,0.00377,24547,92.62669,26501
6316,pabbyt,1,0.00377,24548,92.63047,26501
6317,Pablitox26,1,0.00377,24549,92.63424,26501
6318,pablo-de,1,0.00377,24550,92.63801,26501
6319,packetgeek,1,0.00377,24551,92.64179,26501
6320,pahla1,1,0.00377,24552,92.64556,26501
6321,paipaoso,1,0.00377,24553,92.64933,26501
6322,palakpandita98,1,0.00377,24554,92.65311,26501
6323,palminha,1,0.00377,24555,92.65688,26501
6324,Panda-Abhisek,1,0.00377,24556,92.66065,26501
6325,pandaapo,1,0.00377,24557,92.66443,26501
6326,pangengteng,1,0.00377,24558,92.66820,26501
6327,panilya,1,0.00377,24559,92.67197,26501
6328,paolobyte,1,0.00377,24560,92.67575,26501
6329,parifuture,1,0.00377,24561,92.67952,26501
6330,parimalpatilnuance,1,0.00377,24562,92.68329,26501
6331,paritoshparmar14,1,0.00377,24563,92.68707,26501
6332,ParSal123,1,0.00377,24564,92.69084,26501
6333,PascalDutch,1,0.00377,24565,92.69462,26501
6334,pascalrimann,1,0.00377,24566,92.69839,26501
6335,pasfoter,1,0.00377,24567,92.70216,26501
6336,PasinduTennage,1,0.00377,24568,92.70594,26501
6337,pasupulatisivaji,1,0.00377,24569,92.70971,26501
6338,PatAKnight,1,0.00377,24570,92.71348,26501
6339,patel-aum,1,0.00377,24571,92.71726,26501
6340,patinocode,1,0.00377,24572,92.72103,26501
6341,patrickcorrigan,1,0.00377,24573,92.72480,26501
6342,patrickdillon,1,0.00377,24574,92.72858,26501
6343,patrickocoffeyo,1,0.00377,24575,92.73235,26501
6344,patronus-iitr,1,0.00377,24576,92.73612,26501
6345,paul-b-kr,1,0.00377,24577,92.73990,26501
6346,paulrichter2001,1,0.00377,24578,92.74367,26501
6347,pauqm,1,0.00377,24579,92.74744,26501
6348,Pavan-3,1,0.00377,24580,92.75122,26501
6349,pavanjava,1,0.00377,24581,92.75499,26501
6350,paveliak,1,0.00377,24582,92.75876,26501
6351,PavelPikat,1,0.00377,24583,92.76254,26501
6352,payxn,1,0.00377,24584,92.76631,26501
6353,pballester,1,0.00377,24585,92.77008,26501
6354,pbptaker,1,0.00377,24586,92.77386,26501
6355,pchambre,1,0.00377,24587,92.77763,26501
6356,pclaudinoo,1,0.00377,24588,92.78140,26501
6357,pdelacroix,1,0.00377,24589,92.78518,26501
6358,pdrost-sonrai,1,0.00377,24590,92.78895,26501
6359,peaaceChoi,1,0.00377,24591,92.79272,26501
6360,PeaceRebel,1,0.00377,24592,92.79650,26501
6361,PeakerChen,1,0.00377,24593,92.80027,26501
6362,pealmeid,1,0.00377,24594,92.80405,26501
6363,peccu,1,0.00377,24595,92.80782,26501
6364,pengfei99,1,0.00377,24596,92.81159,26501
6365,PentheusLennuye,1,0.00377,24597,92.81537,26501
6366,pepegar,1,0.00377,24598,92.81914,26501
6367,pergeri,1,0.00377,24599,92.82291,26501
6368,peske,1,0.00377,24600,92.82669,26501
6369,peterbuecker-form3,1,0.00377,24601,92.83046,26501
6370,peterlindsten,1,0.00377,24602,92.83423,26501
6371,pgallmann,1,0.00377,24603,92.83801,26501
6372,pgjavier,1,0.00377,24604,92.84178,26501
6373,pgossa,1,0.00377,24605,92.84555,26501
6374,pgulian-mulesoft,1,0.00377,24606,92.84933,26501
6375,phfnjcqscott,1,0.00377,24607,92.85310,26501
6376,philband,1,0.00377,24608,92.85687,26501
6377,philippn,1,0.00377,24609,92.86065,26501
6378,phil-nelson-bt,1,0.00377,24610,92.86442,26501
6379,phishlabs,1,0.00377,24611,92.86819,26501
6380,phpwutz,1,0.00377,24612,92.87197,26501
6381,PhungVTu,1,0.00377,24613,92.87574,26501
6382,phuongdkyt,1,0.00377,24614,92.87951,26501
6383,phwissmann,1,0.00377,24615,92.88329,26501
6384,PIAy3R,1,0.00377,24616,92.88706,26501
6385,pierotofy,1,0.00377,24617,92.89083,26501
6386,piggy2303,1,0.00377,24618,92.89461,26501
6387,pikrog,1,0.00377,24619,92.89838,26501
6388,Pingoo31,1,0.00377,24620,92.90215,26501
6389,PiotrSzydloRelativity,1,0.00377,24621,92.90593,26501
6390,pipemonNexplore,1,0.00377,24622,92.90970,26501
6391,PisaJan,1,0.00377,24623,92.91347,26501
6392,pjaronek,1,0.00377,24624,92.91725,26501
6393,pjestin,1,0.00377,24625,92.92102,26501
6394,pjrlundy,1,0.00377,24626,92.92480,26501
6395,pjuarezd,1,0.00377,24627,92.92857,26501
6396,pkatakam,1,0.00377,24628,92.93234,26501
6397,pksawicki,1,0.00377,24629,92.93612,26501
6398,pks-ws,1,0.00377,24630,92.93989,26501
6399,plinde,1,0.00377,24631,92.94366,26501
6400,Plork,1,0.00377,24632,92.94744,26501
6401,pmacn,1,0.00377,24633,92.95121,26501
6402,pmalmsten,1,0.00377,24634,92.95498,26501
6403,pmeaney,1,0.00377,24635,92.95876,26501
6404,pmerrison,1,0.00377,24636,92.96253,26501
6405,pmolinam,1,0.00377,24637,92.96630,26501
6406,pmtrc,1,0.00377,24638,92.97008,26501
6407,PoliM,1,0.00377,24639,92.97385,26501
6408,ponnamvivek,1,0.00377,24640,92.97762,26501
6409,pontepotchet,1,0.00377,24641,92.98140,26501
6410,PoojaHoney,1,0.00377,24642,92.98517,26501
6411,poonam-agarwal28,1,0.00377,24643,92.98894,26501
6412,portega-inbrain,1,0.00377,24644,92.99272,26501
6413,portersupport,1,0.00377,24645,92.99649,26501
6414,pourgholi,1,0.00377,24646,93.00026,26501
6415,ppalza,1,0.00377,24647,93.00404,26501
6416,ppp0183,1,0.00377,24648,93.00781,26501
6417,ppratheesh,1,0.00377,24649,93.01158,26501
6418,pprogrammingg,1,0.00377,24650,93.01536,26501
6419,prabhjotbawa,1,0.00377,24651,93.01913,26501
6420,prabuprasad,1,0.00377,24652,93.02290,26501
6421,pragbatra-mendel,1,0.00377,24653,93.02668,26501
6422,prakashiit,1,0.00377,24654,93.03045,26501
6423,prakhar47b,1,0.00377,24655,93.03423,26501
6424,pranavnateri,1,0.00377,24656,93.03800,26501
6425,pranavpsawant,1,0.00377,24657,93.04177,26501
6426,pranay-k12,1,0.00377,24658,93.04555,26501
6427,pranayn,1,0.00377,24659,93.04932,26501
6428,pranayraut,1,0.00377,24660,93.05309,26501
6429,praneshvr00,1,0.00377,24661,93.05687,26501
6430,prashanthitgithub,1,0.00377,24662,93.06064,26501
6431,prashantthorat001,1,0.00377,24663,93.06441,26501
6432,prathap0611,1,0.00377,24664,93.06819,26501
6433,pratheek2shiva,1,0.00377,24665,93.07196,26501
6434,prigluchenie,1,0.00377,24666,93.07573,26501
6435,priitliivak,1,0.00377,24667,93.07951,26501
6436,Prikalel,1,0.00377,24668,93.08328,26501
6437,prismon,1,0.00377,24669,93.08705,26501
6438,pritam-acquia,1,0.00377,24670,93.09083,26501
6439,Prividen,1,0.00377,24671,93.09460,26501
6440,privmc,1,0.00377,24672,93.09837,26501
6441,priyesh2609,1,0.00377,24673,93.10215,26501
6442,priytam1993,1,0.00377,24674,93.10592,26501
6443,prli,1,0.00377,24675,93.10969,26501
6444,probyte12,1,0.00377,24676,93.11347,26501
6445,proea,1,0.00377,24677,93.11724,26501
6446,PronoyC,1,0.00377,24678,93.12101,26501
6447,prushh,1,0.00377,24679,93.12479,26501
6448,PS-14,1,0.00377,24680,93.12856,26501
6449,pschmidbauer,1,0.00377,24681,93.13233,26501
6450,pschroeder89,1,0.00377,24682,93.13611,26501
6451,psfoley,1,0.00377,24683,93.13988,26501
6452,p-sherratt,1,0.00377,24684,93.14365,26501
6453,psmyth-entertainment,1,0.00377,24685,93.14743,26501
6454,ps-spark,1,0.00377,24686,93.15120,26501
6455,pstatham-tx,1,0.00377,24687,93.15498,26501
6456,psypdt,1,0.00377,24688,93.15875,26501
6457,ptimofee,1,0.00377,24689,93.16252,26501
6458,ptodev,1,0.00377,24690,93.16630,26501
6459,puffpuf,1,0.00377,24691,93.17007,26501
6460,pughua,1,0.00377,24692,93.17384,26501
6461,pulkitent,1,0.00377,24693,93.17762,26501
6462,pulungw,1,0.00377,24694,93.18139,26501
6463,puneeth072003,1,0.00377,24695,93.18516,26501
6464,pushker001,1,0.00377,24696,93.18894,26501
6465,pwkoscp123,1,0.00377,24697,93.19271,26501
6466,pxsalehi,1,0.00377,24698,93.19648,26501
6467,pyangzen,1,0.00377,24699,93.20026,26501
6468,pyy000pine,1,0.00377,24700,93.20403,26501
6469,Q5EbA7Vdyw84efER,1,0.00377,24701,93.20780,26501
6470,qapris,1,0.00377,24702,93.21158,26501
6471,q-chrisrogers,1,0.00377,24703,93.21535,26501
6472,QCLectic,1,0.00377,24704,93.21912,26501
6473,qerub,1,0.00377,24705,93.22290,26501
6474,qshchenmo,1,0.00377,24706,93.22667,26501
6475,QuinnJensen,1,0.00377,24707,93.23044,26501
6476,quotalab-dev,1,0.00377,24708,93.23422,26501
6477,qwe125397,1,0.00377,24709,93.23799,26501
6478,qwm-db,1,0.00377,24710,93.24176,26501
6479,r4ve1,1,0.00377,24711,93.24554,26501
6480,raasss,1,0.00377,24712,93.24931,26501
6481,rachedanis,1,0.00377,24713,93.25308,26501
6482,rachit-srivastava,1,0.00377,24714,93.25686,26501
6483,rackerchandra,1,0.00377,24715,93.26063,26501
6484,rafaelbpcrespo,1,0.00377,24716,93.26441,26501
6485,rafael-gumiero,1,0.00377,24717,93.26818,26501
6486,rafaotetra,1,0.00377,24718,93.27195,26501
6487,rafi0101,1,0.00377,24719,93.27573,26501
6488,rafikdraoui,1,0.00377,24720,93.27950,26501
6489,rafsaf,1,0.00377,24721,93.28327,26501
6490,RagingKore,1,0.00377,24722,93.28705,26501
6491,Rahmath-Syed,1,0.00377,24723,93.29082,26501
6492,Rahul1804,1,0.00377,24724,93.29459,26501
6493,rahulpatel033,1,0.00377,24725,93.29837,26501
6494,Rahulsapna,1,0.00377,24726,93.30214,26501
6495,raijenki,1,0.00377,24727,93.30591,26501
6496,rajat-tomar,1,0.00377,24728,93.30969,26501
6497,rajdudi,1,0.00377,24729,93.31346,26501
6498,rajeevpadinharepattu,1,0.00377,24730,93.31723,26501
6499,rajims07,1,0.00377,24731,93.32101,26501
6500,rajshivage,1,0.00377,24732,93.32478,26501
6501,rajudevop,1,0.00377,24733,93.32855,26501
6502,rakhinskiy,1,0.00377,24734,93.33233,26501
6503,RalfWenzel,1,0.00377,24735,93.33610,26501
6504,ralgar,1,0.00377,24736,93.33987,26501
6505,ralienpp,1,0.00377,24737,93.34365,26501
6506,ralph-mcardell,1,0.00377,24738,93.34742,26501
6507,RamaMalladiAWS,1,0.00377,24739,93.35119,26501
6508,raman-babich,1,0.00377,24740,93.35497,26501
6509,rameels,1,0.00377,24741,93.35874,26501
6510,randomtest99,1,0.00377,24742,93.36251,26501
6511,randych-gilad,1,0.00377,24743,93.36629,26501
6512,Rapter1990,1,0.00377,24744,93.37006,26501
6513,rara73,1,0.00377,24745,93.37383,26501
6514,ra-ramos,1,0.00377,24746,93.37761,26501
6515,rasovskym,1,0.00377,24747,93.38138,26501
6516,ratankr39,1,0.00377,24748,93.38516,26501
6517,ratelle,1,0.00377,24749,93.38893,26501
6518,rathawut,1,0.00377,24750,93.39270,26501
6519,ratovarius,1,0.00377,24751,93.39648,26501
6520,Rattnik,1,0.00377,24752,93.40025,26501
6521,ravi100k,1,0.00377,24753,93.40402,26501
6522,ravijkyada,1,0.00377,24754,93.40780,26501
6523,ravin-gloify,1,0.00377,24755,93.41157,26501
6524,ravishthecoder,1,0.00377,24756,93.41534,26501
6525,Rawad84,1,0.00377,24757,93.41912,26501
6526,rayarazan,1,0.00377,24758,93.42289,26501
6527,raydemandforce,1,0.00377,24759,93.42666,26501
6528,raylas,1,0.00377,24760,93.43044,26501
6529,RayOconnor,1,0.00377,24761,93.43421,26501
6530,rayowang,1,0.00377,24762,93.43798,26501
6531,rbharvs,1,0.00377,24763,93.44176,26501
6532,rbrahul-8001,1,0.00377,24764,93.44553,26501
6533,rcarpa,1,0.00377,24765,93.44930,26501
6534,rcbandit111,1,0.00377,24766,93.45308,26501
6535,rdeavilafloqast,1,0.00377,24767,93.45685,26501
6536,rdeveen,1,0.00377,24768,93.46062,26501
6537,rdipika,1,0.00377,24769,93.46440,26501
6538,real-danm,1,0.00377,24770,93.46817,26501
6539,RebecaValadez,1,0.00377,24771,93.47194,26501
6540,reborn1867,1,0.00377,24772,93.47572,26501
6541,redbrick9,1,0.00377,24773,93.47949,26501
6542,redgardner,1,0.00377,24774,93.48326,26501
6543,reedlxm,1,0.00377,24775,93.48704,26501
6544,regaleagle,1,0.00377,24776,93.49081,26501
6545,regmicmahesh,1,0.00377,24777,93.49459,26501
6546,rei-h-kakaoent,1,0.00377,24778,93.49836,26501
6547,reivaxm,1,0.00377,24779,93.50213,26501
6548,rejiem,1,0.00377,24780,93.50591,26501
6549,rejuljames,1,0.00377,24781,93.50968,26501
6550,relcodedev,1,0.00377,24782,93.51345,26501
6551,remeq,1,0.00377,24783,93.51723,26501
6552,remixmabix,1,0.00377,24784,93.52100,26501
6553,renat1sakenov,1,0.00377,24785,93.52477,26501
6554,renatapoluceno,1,0.00377,24786,93.52855,26501
6555,reneroboter,1,0.00377,24787,93.53232,26501
6556,renesepp,1,0.00377,24788,93.53609,26501
6557,resoli,1,0.00377,24789,93.53987,26501
6558,ResPhantom,1,0.00377,24790,93.54364,26501
6559,rexhsu0624,1,0.00377,24791,93.54741,26501
6560,RexTim,1,0.00377,24792,93.55119,26501
6561,ReyanshKharga,1,0.00377,24793,93.55496,26501
6562,reynhartono,1,0.00377,24794,93.55873,26501
6563,reyvonger,1,0.00377,24795,93.56251,26501
6564,rezekdan,1,0.00377,24796,93.56628,26501
6565,rfishrock,1,0.00377,24797,93.57005,26501
6566,rgallis,1,0.00377,24798,93.57383,26501
6567,rgomezceis,1,0.00377,24799,93.57760,26501
6568,rgoomar,1,0.00377,24800,93.58137,26501
6569,rgschmitz1,1,0.00377,24801,93.58515,26501
6570,rgustafs,1,0.00377,24802,93.58892,26501
6571,rhkngw,1,0.00377,24803,93.59269,26501
6572,ribetm,1,0.00377,24804,93.59647,26501
6573,ribua,1,0.00377,24805,93.60024,26501
6574,RicardoCarvalhoo,1,0.00377,24806,93.60401,26501
6575,RiccardoColella1A,1,0.00377,24807,93.60779,26501
6576,richardyc,1,0.00377,24808,93.61156,26501
6577,rickydjohn,1,0.00377,24809,93.61534,26501
6578,rico-qian,1,0.00377,24810,93.61911,26501
6579,rifler,1,0.00377,24811,93.62288,26501
6580,rigma,1,0.00377,24812,93.62666,26501
6581,rigzba21,1,0.00377,24813,93.63043,26501
6582,Riight6254,1,0.00377,24814,93.63420,26501
6583,RiKaCC,1,0.00377,24815,93.63798,26501
6584,rinsuki,1,0.00377,24816,93.64175,26501
6585,Riprock,1,0.00377,24817,93.64552,26501
6586,RishabhKodes,1,0.00377,24818,93.64930,26501
6587,rishu1601,1,0.00377,24819,93.65307,26501
6588,risingspiral,1,0.00377,24820,93.65684,26501
6589,RiveransRafting,1,0.00377,24821,93.66062,26501
6590,River-Prince,1,0.00377,24822,93.66439,26501
6591,rjacobs91,1,0.00377,24823,93.66816,26501
6592,rkashasl,1,0.00377,24824,93.67194,26501
6593,rkazak07,1,0.00377,24825,93.67571,26501
6594,rkg1979,1,0.00377,24826,93.67948,26501
6595,rkorzeniec,1,0.00377,24827,93.68326,26501
6596,rlazimi-dev,1,0.00377,24828,93.68703,26501
6597,r-matsuzaka,1,0.00377,24829,93.69080,26501
6598,R-M-F-at-C-A,1,0.00377,24830,93.69458,26501
6599,rmoyan,1,0.00377,24831,93.69835,26501
6600,RoadToTop,1,0.00377,24832,93.70212,26501
6601,robert-becker-hs,1,0.00377,24833,93.70590,26501
6602,robertchgo,1,0.00377,24834,93.70967,26501
6603,RobertKelly,1,0.00377,24835,93.71344,26501
6604,robertluoxu,1,0.00377,24836,93.71722,26501
6605,RobertVenhryn,1,0.00377,24837,93.72099,26501
6606,robin-varghese,1,0.00377,24838,93.72477,26501
6607,robmoore-i,1,0.00377,24839,93.72854,26501
6608,robotfood,1,0.00377,24840,93.73231,26501
6609,robv8r,1,0.00377,24841,93.73609,26501
6610,rochecompaan,1,0.00377,24842,93.73986,26501
6611,rocketTurbo,1,0.00377,24843,93.74363,26501
6612,RockingSNP,1,0.00377,24844,93.74741,26501
6613,rocna,1,0.00377,24845,93.75118,26501
6614,RocooHash,1,0.00377,24846,93.75495,26501
6615,rodraco,1,0.00377,24847,93.75873,26501
6616,rogelio-o,1,0.00377,24848,93.76250,26501
6617,rogerBridge,1,0.00377,24849,93.76627,26501
6618,rogercloud,1,0.00377,24850,93.77005,26501
6619,RoguedBear,1,0.00377,24851,93.77382,26501
6620,rohan2603,1,0.00377,24852,93.77759,26501
6621,rohanaceres,1,0.00377,24853,93.78137,26501
6622,roiavivi,1,0.00377,24854,93.78514,26501
6623,rolarblaze,1,0.00377,24855,93.78891,26501
6624,roldanx,1,0.00377,24856,93.79269,26501
6625,rolyatmax,1,0.00377,24857,93.79646,26501
6626,roma-glushko,1,0.00377,24858,93.80023,26501
6627,roman-shandurenko,1,0.00377,24859,93.80401,26501
6628,ronanchilvers,1,0.00377,24860,93.80778,26501
6629,ronnelsantiago,1,0.00377,24861,93.81155,26501
6630,ronnieroyston,1,0.00377,24862,93.81533,26501
6631,Ronyk11,1,0.00377,24863,93.81910,26501
6632,roquie,1,0.00377,24864,93.82287,26501
6633,rosberen,1,0.00377,24865,93.82665,26501
6634,roshaans,1,0.00377,24866,93.83042,26501
6635,roubles,1,0.00377,24867,93.83419,26501
6636,rounakdatta,1,0.00377,24868,93.83797,26501
6637,rowansmithau,1,0.00377,24869,93.84174,26501
6638,RoyeA,1,0.00377,24870,93.84552,26501
6639,royzhao7,1,0.00377,24871,93.84929,26501
6640,rparmer,1,0.00377,24872,93.85306,26501
6641,rplst8,1,0.00377,24873,93.85684,26501
6642,rprodan,1,0.00377,24874,93.86061,26501
6643,rraval,1,0.00377,24875,93.86438,26501
6644,rreddy78,1,0.00377,24876,93.86816,26501
6645,rromanchuk,1,0.00377,24877,93.87193,26501
6646,rsajjan3,1,0.00377,24878,93.87570,26501
6647,rsalinas,1,0.00377,24879,93.87948,26501
6648,rsevil-braintly,1,0.00377,24880,93.88325,26501
6649,RSG-12,1,0.00377,24881,93.88702,26501
6650,rsjamwal,1,0.00377,24882,93.89080,26501
6651,rsmartins78,1,0.00377,24883,93.89457,26501
6652,rtrox,1,0.00377,24884,93.89834,26501
6653,rtuin,1,0.00377,24885,93.90212,26501
6654,rubenjoy,1,0.00377,24886,93.90589,26501
6655,rubur-webbeds,1,0.00377,24887,93.90966,26501
6656,ruby-white-ai,1,0.00377,24888,93.91344,26501
6657,Ruckus0143,1,0.00377,24889,93.91721,26501
6658,rudy500,1,0.00377,24890,93.92098,26501
6659,rui-wang-imprivata,1,0.00377,24891,93.92476,26501
6660,rukai,1,0.00377,24892,93.92853,26501
6661,rupurt,1,0.00377,24893,93.93230,26501
6662,rushanq,1,0.00377,24894,93.93608,26501
6663,rushikeshkulat,1,0.00377,24895,93.93985,26501
6664,ruwaifaa,1,0.00377,24896,93.94362,26501
6665,rvadisala,1,0.00377,24897,93.94740,26501
6666,rvitorgomes,1,0.00377,24898,93.95117,26501
6667,rwatler,1,0.00377,24899,93.95495,26501
6668,rxw,1,0.00377,24900,93.95872,26501
6669,ryan-bradford,1,0.00377,24901,93.96249,26501
6670,ryanf351,1,0.00377,24902,93.96627,26501
6671,ryanfolsom,1,0.00377,24903,93.97004,26501
6672,rymai,1,0.00377,24904,93.97381,26501
6673,rymir,1,0.00377,24905,93.97759,26501
6674,ryo-honda,1,0.00377,24906,93.98136,26501
6675,RzaAhmadi,1,0.00377,24907,93.98513,26501
6676,S0LERA,1,0.00377,24908,93.98891,26501
6677,s4pfyr,1,0.00377,24909,93.99268,26501
6678,S627,1,0.00377,24910,93.99645,26501
6679,s6341887,1,0.00377,24911,94.00023,26501
6680,saadousman,1,0.00377,24912,94.00400,26501
6681,sachinkine,1,0.00377,24913,94.00777,26501
6682,sa-ChristianAnton,1,0.00377,24914,94.01155,26501
6683,SafeEval,1,0.00377,24915,94.01532,26501
6684,sagar0419,1,0.00377,24916,94.01909,26501
6685,sagarbhatt2290,1,0.00377,24917,94.02287,26501
6686,sagarkhatri200,1,0.00377,24918,94.02664,26501
6687,sagarm-traveloka,1,0.00377,24919,94.03041,26501
6688,sagarputta,1,0.00377,24920,94.03419,26501
6689,Saha-7,1,0.00377,24921,94.03796,26501
6690,sahapasci,1,0.00377,24922,94.04173,26501
6691,Sahildeep,1,0.00377,24923,94.04551,26501
6692,Saichovsky,1,0.00377,24924,94.04928,26501
6693,saifelse,1,0.00377,24925,94.05305,26501
6694,saifxd7,1,0.00377,24926,94.05683,26501
6695,SaiJyothiGudibandi,1,0.00377,24927,94.06060,26501
6696,saikrthk1322,1,0.00377,24928,94.06437,26501
6697,sainookala,1,0.00377,24929,94.06815,26501
6698,sairamnat,1,0.00377,24930,94.07192,26501
6699,sakmalh,1,0.00377,24931,94.07570,26501
6700,salehsedghpour,1,0.00377,24932,94.07947,26501
6701,saleson,1,0.00377,24933,94.08324,26501
6702,sallylyen,1,0.00377,24934,94.08702,26501
6703,SalmaSamy,1,0.00377,24935,94.09079,26501
6704,Saloni1814,1,0.00377,24936,94.09456,26501
6705,SaltyCoco,1,0.00377,24937,94.09834,26501
6706,Sam-Amin,1,0.00377,24938,94.10211,26501
6707,samanthacastille,1,0.00377,24939,94.10588,26501
6708,samba2,1,0.00377,24940,94.10966,26501
6709,samerdokas,1,0.00377,24941,94.11343,26501
6710,samgang,1,0.00377,24942,94.11720,26501
6711,sam-goodwin,1,0.00377,24943,94.12098,26501
6712,samihoda,1,0.00377,24944,94.12475,26501
6713,samirtahir91,1,0.00377,24945,94.12852,26501
6714,samjmarshall,1,0.00377,24946,94.13230,26501
6715,samkline,1,0.00377,24947,94.13607,26501
6716,SammyFidato,1,0.00377,24948,94.13984,26501
6717,samridhrakesh,1,0.00377,24949,94.14362,26501
6718,SamuelDeal,1,0.00377,24950,94.14739,26501
6719,SamuelJohnson01997,1,0.00377,24951,94.15116,26501
6720,SamuelXv,1,0.00377,24952,94.15494,26501
6721,san-chang,1,0.00377,24953,94.15871,26501
6722,sandeepa-kv-jois,1,0.00377,24954,94.16248,26501
6723,Sandip-Ayush,1,0.00377,24955,94.16626,26501
6724,sandipdhagdi,1,0.00377,24956,94.17003,26501
6725,SandroHc,1,0.00377,24957,94.17380,26501
6726,sandros06,1,0.00377,24958,94.17758,26501
6727,SandyDomu,1,0.00377,24959,94.18135,26501
6728,sandy-lcq,1,0.00377,24960,94.18513,26501
6729,sanghunka,1,0.00377,24961,94.18890,26501
6730,sanketsystems,1,0.00377,24962,94.19267,26501
6731,sanmaym,1,0.00377,24963,94.19645,26501
6732,Sansh20,1,0.00377,24964,94.20022,26501
6733,santiago8781,1,0.00377,24965,94.20399,26501
6734,santoshchilkunda,1,0.00377,24966,94.20777,26501
6735,santoshkumarindia,1,0.00377,24967,94.21154,26501
6736,Saphora,1,0.00377,24968,94.21531,26501
6737,Sapp00,1,0.00377,24969,94.21909,26501
6738,sarh2o,1,0.00377,24970,94.22286,26501
6739,sarroutbi,1,0.00377,24971,94.22663,26501
6740,SatabrataPaul-GitAc,1,0.00377,24972,94.23041,26501
6741,satanshiro,1,0.00377,24973,94.23418,26501
6742,SatishReddyBethi,1,0.00377,24974,94.23795,26501
6743,sattha,1,0.00377,24975,94.24173,26501
6744,SaudIqbal-IITM,1,0.00377,24976,94.24550,26501
6745,saukrs,1,0.00377,24977,94.24927,26501
6746,Saurabh18R,1,0.00377,24978,94.25305,26501
6747,savipavan,1,0.00377,24979,94.25682,26501
6748,Sayanc2000,1,0.00377,24980,94.26059,26501
6749,sayanseal,1,0.00377,24981,94.26437,26501
6750,sayantandasgupta,1,0.00377,24982,94.26814,26501
6751,sbanala12,1,0.00377,24983,94.27191,26501
6752,sbanna-nomad,1,0.00377,24984,94.27569,26501
6753,sbarrypoppulo,1,0.00377,24985,94.27946,26501
6754,SBatais,1,0.00377,24986,94.28323,26501
6755,sberthier,1,0.00377,24987,94.28701,26501
6756,sbrawner,1,0.00377,24988,94.29078,26501
6757,sbzimpart,1,0.00377,24989,94.29455,26501
6758,ScGPS,1,0.00377,24990,94.29833,26501
6759,schalla0791,1,0.00377,24991,94.30210,26501
6760,schedin,1,0.00377,24992,94.30588,26501
6761,schmitz-chris,1,0.00377,24993,94.30965,26501
6762,schonbachler,1,0.00377,24994,94.31342,26501
6763,schwern,1,0.00377,24995,94.31720,26501
6764,scott-haines-se,1,0.00377,24996,94.32097,26501
6765,scottpantall,1,0.00377,24997,94.32474,26501
6766,ScottSedgwick,1,0.00377,24998,94.32852,26501
6767,scottsidwell,1,0.00377,24999,94.33229,26501
6768,scottso,1,0.00377,25000,94.33606,26501
6769,SD145,1,0.00377,25001,94.33984,26501
6770,sdsingh07,1,0.00377,25002,94.34361,26501
6771,searce-aditya,1,0.00377,25003,94.34738,26501
6772,sebasnabas,1,0.00377,25004,94.35116,26501
6773,sebastienmusso,1,0.00377,25005,94.35493,26501
6774,sebbegg,1,0.00377,25006,94.35870,26501
6775,sebinnsebastian,1,0.00377,25007,94.36248,26501
6776,seb-kw,1,0.00377,25008,94.36625,26501
6777,sebrandon1,1,0.00377,25009,94.37002,26501
6778,sebsthiel,1,0.00377,25010,94.37380,26501
6779,sebv004,1,0.00377,25011,94.37757,26501
6780,seffyB,1,0.00377,25012,94.38134,26501
6781,segoon,1,0.00377,25013,94.38512,26501
6782,selfissued,1,0.00377,25014,94.38889,26501
6783,semmet95,1,0.00377,25015,94.39266,26501
6784,senanjude0,1,0.00377,25016,94.39644,26501
6785,senthilanantha,1,0.00377,25017,94.40021,26501
6786,sepbot,1,0.00377,25018,94.40398,26501
6787,SergeyBerhov,1,0.00377,25019,94.40776,26501
6788,sergioegutierrez,1,0.00377,25020,94.41153,26501
6789,sergio-ferreira-jscrambler,1,0.00377,25021,94.41531,26501
6790,sergio-opslevel,1,0.00377,25022,94.41908,26501
6791,SerhiiPodlesnyi,1,0.00377,25023,94.42285,26501
6792,Serpent6877,1,0.00377,25024,94.42663,26501
6793,Setre14,1,0.00377,25025,94.43040,26501
6794,sfc-gh-bxin,1,0.00377,25026,94.43417,26501
6795,sfc-gh-tkommineni,1,0.00377,25027,94.43795,26501
6796,sforce100,1,0.00377,25028,94.44172,26501
6797,sgartner03,1,0.00377,25029,94.44549,26501
6798,sgnay,1,0.00377,25030,94.44927,26501
6799,sgrotz-cepres,1,0.00377,25031,94.45304,26501
6800,ShadowApex,1,0.00377,25032,94.45681,26501
6801,Shadowssong,1,0.00377,25033,94.46059,26501
6802,shahabedinh,1,0.00377,25034,94.46436,26501
6803,shahkv95,1,0.00377,25035,94.46813,26501
6804,ShahroozAnsari,1,0.00377,25036,94.47191,26501
6805,shahzadlearn,1,0.00377,25037,94.47568,26501
6806,shaikhtousif1,1,0.00377,25038,94.47945,26501
6807,shaileshct09021,1,0.00377,25039,94.48323,26501
6808,shaked-develeap,1,0.00377,25040,94.48700,26501
6809,shanjunmei,1,0.00377,25041,94.49077,26501
6810,shankarm123,1,0.00377,25042,94.49455,26501
6811,shanthkumar079,1,0.00377,25043,94.49832,26501
6812,sharanraj124,1,0.00377,25044,94.50209,26501
6813,Sharechat-Taran,1,0.00377,25045,94.50587,26501
6814,sharmamona,1,0.00377,25046,94.50964,26501
6815,SharmiSk,1,0.00377,25047,94.51341,26501
6816,ShashankKavli,1,0.00377,25048,94.51719,26501
6817,shashidhar0711,1,0.00377,25049,94.52096,26501
6818,shawan-bkash,1,0.00377,25050,94.52473,26501
6819,shawinder,1,0.00377,25051,94.52851,26501
6820,shawna-donnelly,1,0.00377,25052,94.53228,26501
6821,shawnkhoffman,1,0.00377,25053,94.53606,26501
6822,Shawn-Yang-AWX,1,0.00377,25054,94.53983,26501
6823,shawven,1,0.00377,25055,94.54360,26501
6824,sheriff-rh,1,0.00377,25056,94.54738,26501
6825,sheshesheshe,1,0.00377,25057,94.55115,26501
6826,shilpisinha895,1,0.00377,25058,94.55492,26501
6827,ShimonOhayon,1,0.00377,25059,94.55870,26501
6828,shin04,1,0.00377,25060,94.56247,26501
6829,shiny-zero,1,0.00377,25061,94.56624,26501
6830,shishkin,1,0.00377,25062,94.57002,26501
6831,shivang0-0,1,0.00377,25063,94.57379,26501
6832,ShivankK26,1,0.00377,25064,94.57756,26501
6833,Shivann2,1,0.00377,25065,94.58134,26501
6834,Shl007,1,0.00377,25066,94.58511,26501
6835,ShreyasKali01,1,0.00377,25067,94.58888,26501
6836,shrikantdhomane,1,0.00377,25068,94.59266,26501
6837,shruthihub,1,0.00377,25069,94.59643,26501
6838,shrutiebony,1,0.00377,25070,94.60020,26501
6839,shuai-zh,1,0.00377,25071,94.60398,26501
6840,shubhamsetia05,1,0.00377,25072,94.60775,26501
6841,shubham-uipath,1,0.00377,25073,94.61152,26501
6842,shubhodeep9,1,0.00377,25074,94.61530,26501
6843,shuncon,1,0.00377,25075,94.61907,26501
6844,ShunjiTakano,1,0.00377,25076,94.62284,26501
6845,shuvozula,1,0.00377,25077,94.62662,26501
6846,shyamtawli,1,0.00377,25078,94.63039,26501
6847,siavashingka,1,0.00377,25079,94.63416,26501
6848,sibanipr,1,0.00377,25080,94.63794,26501
6849,sichenzhao,1,0.00377,25081,94.64171,26501
6850,siddharthg,1,0.00377,25082,94.64549,26501
6851,siggibdiac,1,0.00377,25083,94.64926,26501
6852,SignorMercurio,1,0.00377,25084,94.65303,26501
6853,SiiiiiiD,1,0.00377,25085,94.65681,26501
6854,sijonelis,1,0.00377,25086,94.66058,26501
6855,siliconsheep,1,0.00377,25087,94.66435,26501
6856,SilkeP,1,0.00377,25088,94.66813,26501
6857,simon-fu,1,0.00377,25089,94.67190,26501
6858,simplezhao,1,0.00377,25090,94.67567,26501
6859,singlecheeze,1,0.00377,25091,94.67945,26501
6860,Sinokio,1,0.00377,25092,94.68322,26501
6861,sinungp,1,0.00377,25093,94.68699,26501
6862,SirRanger,1,0.00377,25094,94.69077,26501
6863,siva143sp,1,0.00377,25095,94.69454,26501
6864,Siyuan01,1,0.00377,25096,94.69831,26501
6865,sjoerddal-pti,1,0.00377,25097,94.70209,26501
6866,s-johansson,1,0.00377,25098,94.70586,26501
6867,sjuls,1,0.00377,25099,94.70963,26501
6868,sk4mi,1,0.00377,25100,94.71341,26501
6869,skerchouni59,1,0.00377,25101,94.71718,26501
6870,skimwpi,1,0.00377,25102,94.72095,26501
6871,sklepcode,1,0.00377,25103,94.72473,26501
6872,sk-pub,1,0.00377,25104,94.72850,26501
6873,skundudtc,1,0.00377,25105,94.73227,26501
6874,sky-jpg,1,0.00377,25106,94.73605,26501
6875,skykit-karlkroening,1,0.00377,25107,94.73982,26501
6876,skynetn1fan,1,0.00377,25108,94.74359,26501
6877,slalbertojesus,1,0.00377,25109,94.74737,26501
6878,slamgundam,1,0.00377,25110,94.75114,26501
6879,slb235,1,0.00377,25111,94.75491,26501
6880,sleepy2333,1,0.00377,25112,94.75869,26501
6881,sloppycoder,1,0.00377,25113,94.76246,26501
6882,SlothCroissant,1,0.00377,25114,94.76624,26501
6883,sltpaya,1,0.00377,25115,94.77001,26501
6884,SmaineTF1,1,0.00377,25116,94.77378,26501
6885,smallst,1,0.00377,25117,94.77756,26501
6886,smigacz,1,0.00377,25118,94.78133,26501
6887,smolit,1,0.00377,25119,94.78510,26501
6888,sne4ker,1,0.00377,25120,94.78888,26501
6889,snigdha920,1,0.00377,25121,94.79265,26501
6890,SnowWindSaveYou,1,0.00377,25122,94.79642,26501
6891,soasme,1,0.00377,25123,94.80020,26501
6892,sodared,1,0.00377,25124,94.80397,26501
6893,Sohan-nykaa,1,0.00377,25125,94.80774,26501
6894,sojakub,1,0.00377,25126,94.81152,26501
6895,sokolbiba,1,0.00377,25127,94.81529,26501
6896,solacese,1,0.00377,25128,94.81906,26501
6897,solarkaka,1,0.00377,25129,94.82284,26501
6898,Sollimann,1,0.00377,25130,94.82661,26501
6899,soltiz,1,0.00377,25131,94.83038,26501
6900,someone-stole-my-name,1,0.00377,25132,94.83416,26501
6901,somepad,1,0.00377,25133,94.83793,26501
6902,Somiacao,1,0.00377,25134,94.84170,26501
6903,sonawadekarraj,1,0.00377,25135,94.84548,26501
6904,sooslaca,1,0.00377,25136,94.84925,26501
6905,soostdijck,1,0.00377,25137,94.85302,26501
6906,sorazy,1,0.00377,25138,94.85680,26501
6907,soulteary,1,0.00377,25139,94.86057,26501
6908,souravgupta-msft,1,0.00377,25140,94.86434,26501
6909,soytumadre,1,0.00377,25141,94.86812,26501
6910,Spaceconte,1,0.00377,25142,94.87189,26501
6911,spakinz,1,0.00377,25143,94.87567,26501
6912,spanglerco,1,0.00377,25144,94.87944,26501
6913,sparcs360,1,0.00377,25145,94.88321,26501
6914,spaz88,1,0.00377,25146,94.88699,26501
6915,speter555,1,0.00377,25147,94.89076,26501
6916,splunkenizer,1,0.00377,25148,94.89453,26501
6917,SpringManCN,1,0.00377,25149,94.89831,26501
6918,sqldropper,1,0.00377,25150,94.90208,26501
6919,srasahu,1,0.00377,25151,94.90585,26501
6920,srd424,1,0.00377,25152,94.90963,26501
6921,Sreelal-VU,1,0.00377,25153,94.91340,26501
6922,s-reynier,1,0.00377,25154,94.91717,26501
6923,srinikr1972,1,0.00377,25155,94.92095,26501
6924,srisubra-uber,1,0.00377,25156,94.92472,26501
6925,SRV332003,1,0.00377,25157,94.92849,26501
6926,ssainz,1,0.00377,25158,94.93227,26501
6927,ssaleh97,1,0.00377,25159,94.93604,26501
6928,ssantrosyan,1,0.00377,25160,94.93981,26501
6929,ssh30,1,0.00377,25161,94.94359,26501
6930,sshu2017,1,0.00377,25162,94.94736,26501
6931,ssinha3,1,0.00377,25163,94.95113,26501
6932,ssoriche,1,0.00377,25164,94.95491,26501
6933,sss-cvs,1,0.00377,25165,94.95868,26501
6934,sst1xx,1,0.00377,25166,94.96245,26501
6935,ss-torres,1,0.00377,25167,94.96623,26501
6936,sstunkel,1,0.00377,25168,94.97000,26501
6937,stamog,1,0.00377,25169,94.97377,26501
6938,stanleymho,1,0.00377,25170,94.97755,26501
6939,Stanwell1,1,0.00377,25171,94.98132,26501
6940,Starr79,1,0.00377,25172,94.98509,26501
6941,Starter-luke,1,0.00377,25173,94.98887,26501
6942,starwarsfan,1,0.00377,25174,94.99264,26501
6943,stbeckers,1,0.00377,25175,94.99642,26501
6944,stefan-fast,1,0.00377,25176,95.00019,26501
6945,stefan-kiss,1,0.00377,25177,95.00396,26501
6946,Stefan-Mihail,1,0.00377,25178,95.00774,26501
6947,stefanvanburen,1,0.00377,25179,95.01151,26501
6948,steffenneyt,1,0.00377,25180,95.01528,26501
6949,stefin9898,1,0.00377,25181,95.01906,26501
6950,stepan-3,1,0.00377,25182,95.02283,26501
6951,stephan-windischmann-sky,1,0.00377,25183,95.02660,26501
6952,stephenburrows22,1,0.00377,25184,95.03038,26501
6953,stephgosling,1,0.00377,25185,95.03415,26501
6954,SterlingMcKinley,1,0.00377,25186,95.03792,26501
6955,stevedef,1,0.00377,25187,95.04170,26501
6956,stevenchou18q7,1,0.00377,25188,95.04547,26501
6957,steven-ferguson,1,0.00377,25189,95.04924,26501
6958,Stevenyau123,1,0.00377,25190,95.05302,26501
6959,SteveProXNA,1,0.00377,25191,95.05679,26501
6960,SteveRosam,1,0.00377,25192,95.06056,26501
6961,SteversIO,1,0.00377,25193,95.06434,26501
6962,StinkyBenji,1,0.00377,25194,95.06811,26501
6963,stoovon,1,0.00377,25195,95.07188,26501
6964,Strigix,1,0.00377,25196,95.07566,26501
6965,Stsrjffjc,1,0.00377,25197,95.07943,26501
6966,stuartdotnet,1,0.00377,25198,95.08320,26501
6967,studychao,1,0.00377,25199,95.08698,26501
6968,subasathees,1,0.00377,25200,95.09075,26501
6969,subash-krishnan,1,0.00377,25201,95.09452,26501
6970,sudarshaana,1,0.00377,25202,95.09830,26501
6971,sudarshanshenoy,1,0.00377,25203,95.10207,26501
6972,sufiyanpk7,1,0.00377,25204,95.10585,26501
6973,sugunmachipeddy,1,0.00377,25205,95.10962,26501
6974,suhancz,1,0.00377,25206,95.11339,26501
6975,suhasagasthya,1,0.00377,25207,95.11717,26501
6976,suji007,1,0.00377,25208,95.12094,26501
6977,sukki37,1,0.00377,25209,95.12471,26501
6978,sumanpaikdev,1,0.00377,25210,95.12849,26501
6979,sumitsrivastava069,1,0.00377,25211,95.13226,26501
6980,SummerSunFlower,1,0.00377,25212,95.13603,26501
6981,sunir1,1,0.00377,25213,95.13981,26501
6982,sunnysudershan,1,0.00377,25214,95.14358,26501
6983,sunqijun1,1,0.00377,25215,95.14735,26501
6984,SuperClyder,1,0.00377,25216,95.15113,26501
6985,supergrilo-cw,1,0.00377,25217,95.15490,26501
6986,Supgoku,1,0.00377,25218,95.15867,26501
6987,sushilbaligar,1,0.00377,25219,95.16245,26501
6988,suyanhanx,1,0.00377,25220,95.16622,26501
6989,svengeance,1,0.00377,25221,95.16999,26501
6990,sw47,1,0.00377,25222,95.17377,26501
6991,swantzter,1,0.00377,25223,95.17754,26501
6992,swap357,1,0.00377,25224,95.18131,26501
6993,SwapnilThatte,1,0.00377,25225,95.18509,26501
6994,swathikatlaparti,1,0.00377,25226,95.18886,26501
6995,swbsf,1,0.00377,25227,95.19263,26501
6996,swerder-coop,1,0.00377,25228,95.19641,26501
6997,swyrik,1,0.00377,25229,95.20018,26501
6998,syamprasadsiddabattula,1,0.00377,25230,95.20395,26501
6999,SyedAsadRazaDevops,1,0.00377,25231,95.20773,26501
7000,symedley,1,0.00377,25232,95.21150,26501
7001,szaimen,1,0.00377,25233,95.21527,26501
7002,szomx96,1,0.00377,25234,95.21905,26501
7003,szshary,1,0.00377,25235,95.22282,26501
7004,Taaang,1,0.00377,25236,95.22660,26501
7005,tabajara-scontain,1,0.00377,25237,95.23037,26501
7006,TaboolaGruber,1,0.00377,25238,95.23414,26501
7007,tabuyos,1,0.00377,25239,95.23792,26501
7008,tackish,1,0.00377,25240,95.24169,26501
7009,tahasharif2000,1,0.00377,25241,95.24546,26501
7010,taj-p,1,0.00377,25242,95.24924,26501
7011,TakashiAbe0309,1,0.00377,25243,95.25301,26501
7012,takei-ryuichi,1,0.00377,25244,95.25678,26501
7013,Takerman,1,0.00377,25245,95.26056,26501
7014,taleinat,1,0.00377,25246,95.26433,26501
7015,talevy-runai,1,0.00377,25247,95.26810,26501
7016,talsabagport,1,0.00377,25248,95.27188,26501
7017,tangcent,1,0.00377,25249,95.27565,26501
7018,tangducthinh456,1,0.00377,25250,95.27942,26501
7019,tangyouzzz,1,0.00377,25251,95.28320,26501
7020,tanja3981,1,0.00377,25252,95.28697,26501
7021,tank104,1,0.00377,25253,95.29074,26501
7022,tanken,1,0.00377,25254,95.29452,26501
7023,tannguyen244,1,0.00377,25255,95.29829,26501
7024,Tanyril,1,0.00377,25256,95.30206,26501
7025,Tapasdgp,1,0.00377,25257,95.30584,26501
7026,tarun-kumar23,1,0.00377,25258,95.30961,26501
7027,Tasteful,1,0.00377,25259,95.31338,26501
7028,taylow,1,0.00377,25260,95.31716,26501
7029,Tazmain,1,0.00377,25261,95.32093,26501
7030,tcoffin,1,0.00377,25262,95.32470,26501
7031,td-harness,1,0.00377,25263,95.32848,26501
7032,TeamworkGuy2,1,0.00377,25264,95.33225,26501
7033,tebo-ernstberger,1,0.00377,25265,95.33603,26501
7034,tecentwenping,1,0.00377,25266,95.33980,26501
7035,techietommy,1,0.00377,25267,95.34357,26501
7036,Technicalnikhi,1,0.00377,25268,95.34735,26501
7037,teethediva34,1,0.00377,25269,95.35112,26501
7038,teguhbudhi13,1,0.00377,25270,95.35489,26501
7039,tehbooom,1,0.00377,25271,95.35867,26501
7040,TehilaRamati,1,0.00377,25272,95.36244,26501
7041,Teja446,1,0.00377,25273,95.36621,26501
7042,tejas115,1,0.00377,25274,95.36999,26501
7043,Tejaswi43,1,0.00377,25275,95.37376,26501
7044,teknetik,1,0.00377,25276,95.37753,26501
7045,Teko012,1,0.00377,25277,95.38131,26501
7046,tempus-patrickavedian,1,0.00377,25278,95.38508,26501
7047,TengCheng,1,0.00377,25279,95.38885,26501
7048,teo-tsirpanis,1,0.00377,25280,95.39263,26501
7049,terwey,1,0.00377,25281,95.39640,26501
7050,teskje,1,0.00377,25282,95.40017,26501
7051,TestRep1,1,0.00377,25283,95.40395,26501
7052,Tette6969,1,0.00377,25284,95.40772,26501
7053,tf8278,1,0.00377,25285,95.41149,26501
7054,TFiroozian,1,0.00377,25286,95.41527,26501
7055,tfrenz010900,1,0.00377,25287,95.41904,26501
7056,tgeo-cambrian,1,0.00377,25288,95.42281,26501
7057,thadjohnston,1,0.00377,25289,95.42659,26501
7058,thakurrishabh,1,0.00377,25290,95.43036,26501
7059,thalescosta,1,0.00377,25291,95.43413,26501
7060,tharkunns,1,0.00377,25292,95.43791,26501
7061,The-Debarghya,1,0.00377,25293,95.44168,26501
7062,thedeepc,1,0.00377,25294,95.44545,26501
7063,TheDevarshiShah,1,0.00377,25295,95.44923,26501
7064,Thedin87,1,0.00377,25296,95.45300,26501
7065,thees,1,0.00377,25297,95.45678,26501
7066,thehandsomezebra,1,0.00377,25298,95.46055,26501
7067,the-it-jaeger,1,0.00377,25299,95.46432,26501
7068,thejasvi104,1,0.00377,25300,95.46810,26501
7069,thejcannon,1,0.00377,25301,95.47187,26501
7070,thejsdeveloper,1,0.00377,25302,95.47564,26501
7071,thelonelyDreamer,1,0.00377,25303,95.47942,26501
7072,themanforfree,1,0.00377,25304,95.48319,26501
7073,themiken,1,0.00377,25305,95.48696,26501
7074,thenamehasbeentake,1,0.00377,25306,95.49074,26501
7075,Thenitesh143,1,0.00377,25307,95.49451,26501
7076,TheoBassaw,1,0.00377,25308,95.49828,26501
7077,TheodoreCAshmore,1,0.00377,25309,95.50206,26501
7078,theyashwanthsai,1,0.00377,25310,95.50583,26501
7079,thibaudlf,1,0.00377,25311,95.50960,26501
7080,thihathura,1,0.00377,25312,95.51338,26501
7081,thinh2,1,0.00377,25313,95.51715,26501
7082,thirisangu84,1,0.00377,25314,95.52092,26501
7083,thisisheymde,1,0.00377,25315,95.52470,26501
7084,Thnai,1,0.00377,25316,95.52847,26501
7085,thober35,1,0.00377,25317,95.53224,26501
7086,ThomasBuchinger,1,0.00377,25318,95.53602,26501
7087,thomasender,1,0.00377,25319,95.53979,26501
7088,thomas-grininger,1,0.00377,25320,95.54356,26501
7089,thoraage,1,0.00377,25321,95.54734,26501
7090,thorntonmc,1,0.00377,25322,95.55111,26501
7091,Thuan220820,1,0.00377,25323,95.55488,26501
7092,ThumbGen,1,0.00377,25324,95.55866,26501
7093,ThumNet,1,0.00377,25325,95.56243,26501
7094,tianzhou,1,0.00377,25326,95.56621,26501
7095,tibco-ranjan,1,0.00377,25327,95.56998,26501
7096,TIBCOtzhu,1,0.00377,25328,95.57375,26501
7097,Tibo75,1,0.00377,25329,95.57753,26501
7098,tierpod,1,0.00377,25330,95.58130,26501
7099,tieungao88,1,0.00377,25331,95.58507,26501
7100,tigonguyen,1,0.00377,25332,95.58885,26501
7101,tiix95,1,0.00377,25333,95.59262,26501
7102,tikarammardi,1,0.00377,25334,95.59639,26501
7103,tiknam,1,0.00377,25335,95.60017,26501
7104,tiliev,1,0.00377,25336,95.60394,26501
7105,timAdrien,1,0.00377,25337,95.60771,26501
7106,timbuchinger,1,0.00377,25338,95.61149,26501
7107,TimekillerTK,1,0.00377,25339,95.61526,26501
7108,tim-kilian,1,0.00377,25340,95.61903,26501
7109,timlynch2k,1,0.00377,25341,95.62281,26501
7110,timnee,1,0.00377,25342,95.62658,26501
7111,timo-42,1,0.00377,25343,95.63035,26501
7112,timoguin,1,0.00377,25344,95.63413,26501
7113,TimoPtr,1,0.00377,25345,95.63790,26501
7114,timoreize,1,0.00377,25346,95.64167,26501
7115,TimSalomons,1,0.00377,25347,95.64545,26501
7116,Tina-otoge,1,0.00377,25348,95.64922,26501
7117,tingrui-AWS-EKS-auth,1,0.00377,25349,95.65299,26501
7118,Tiny-Wei,1,0.00377,25350,95.65677,26501
7119,titogarrido,1,0.00377,25351,95.66054,26501
7120,tizz98,1,0.00377,25352,95.66431,26501
7121,tkat0,1,0.00377,25353,95.66809,26501
7122,tlb1galaxy,1,0.00377,25354,95.67186,26501
7123,tleerai,1,0.00377,25355,95.67563,26501
7124,tl-sebastien-kovacs,1,0.00377,25356,95.67941,26501
7125,tm604,1,0.00377,25357,95.68318,26501
7126,tmad,1,0.00377,25358,95.68696,26501
7127,tmojzes,1,0.00377,25359,95.69073,26501
7128,tnayhsud,1,0.00377,25360,95.69450,26501
7129,tnsardesai,1,0.00377,25361,95.69828,26501
7130,toaster74,1,0.00377,25362,95.70205,26501
7131,tobbyioa,1,0.00377,25363,95.70582,26501
7132,TodorBalabanski,1,0.00377,25364,95.70960,26501
7133,TomasKuznetsov,1,0.00377,25365,95.71337,26501
7134,tomasliumparas,1,0.00377,25366,95.71714,26501
7135,tomb50,1,0.00377,25367,95.72092,26501
7136,tomek-US,1,0.00377,25368,95.72469,26501
7137,tomergreenwald,1,0.00377,25369,95.72846,26501
7138,tomhoward87,1,0.00377,25370,95.73224,26501
7139,tom-mckay,1,0.00377,25371,95.73601,26501
7140,tomscarlato,1,0.00377,25372,95.73978,26501
7141,tomxiaoyi,1,0.00377,25373,95.74356,26501
7142,tonkers-kuma,1,0.00377,25374,95.74733,26501
7143,tonydelanuez,1,0.00377,25375,95.75110,26501
7144,tonytauller,1,0.00377,25376,95.75488,26501
7145,ToReCi,1,0.00377,25377,95.75865,26501
7146,torsten-online,1,0.00377,25378,95.76242,26501
7147,Totalus,1,0.00377,25379,95.76620,26501
7148,tourze,1,0.00377,25380,95.76997,26501
7149,tpanza,1,0.00377,25381,95.77374,26501
7150,tpzumezawa,1,0.00377,25382,95.77752,26501
7151,Trackr2014,1,0.00377,25383,95.78129,26501
7152,Traktorea,1,0.00377,25384,95.78506,26501
7153,tranngoclam,1,0.00377,25385,95.78884,26501
7154,trapezoid,1,0.00377,25386,95.79261,26501
7155,trasyia,1,0.00377,25387,95.79639,26501
7156,trevenrawr,1,0.00377,25388,95.80016,26501
7157,tricktron,1,0.00377,25389,95.80393,26501
7158,T-RN-R,1,0.00377,25390,95.80771,26501
7159,tropnikovvl,1,0.00377,25391,95.81148,26501
7160,trulicups,1,0.00377,25392,95.81525,26501
7161,trungdlp-wolffun,1,0.00377,25393,95.81903,26501
7162,truongnht,1,0.00377,25394,95.82280,26501
7163,trupti2003,1,0.00377,25395,95.82657,26501
7164,trydalch,1,0.00377,25396,95.83035,26501
7165,tschwade,1,0.00377,25397,95.83412,26501
7166,tsj008,1,0.00377,25398,95.83789,26501
7167,ttq-ak,1,0.00377,25399,95.84167,26501
7168,ttsvetanov92,1,0.00377,25400,95.84544,26501
7169,tuaris,1,0.00377,25401,95.84921,26501
7170,tucktuck9,1,0.00377,25402,95.85299,26501
7171,tumichnix,1,0.00377,25403,95.85676,26501
7172,tunahanertekin,1,0.00377,25404,95.86053,26501
7173,tung-dao-dpk,1,0.00377,25405,95.86431,26501
7174,tungngreen,1,0.00377,25406,95.86808,26501
7175,tungtt1006,1,0.00377,25407,95.87185,26501
7176,TuningYourCode,1,0.00377,25408,95.87563,26501
7177,Tu-S,1,0.00377,25409,95.87940,26501
7178,TusharShahi,1,0.00377,25410,95.88317,26501
7179,tushartgupta,1,0.00377,25411,95.88695,26501
7180,Tushendra,1,0.00377,25412,95.89072,26501
7181,twinzom,1,0.00377,25413,95.89449,26501
7182,twogoods,1,0.00377,25414,95.89827,26501
7183,tyl1024,1,0.00377,25415,95.90204,26501
7184,tylertitsworth,1,0.00377,25416,95.90581,26501
7185,Tymeade,1,0.00377,25417,95.90959,26501
7186,ubreckner,1,0.00377,25418,95.91336,26501
7187,ucinskij,1,0.00377,25419,95.91714,26501
7188,udidn,1,0.00377,25420,95.92091,26501
7189,uditsharma19,1,0.00377,25421,95.92468,26501
7190,udungg,1,0.00377,25422,95.92846,26501
7191,udyshnkr,1,0.00377,25423,95.93223,26501
7192,uempfel,1,0.00377,25424,95.93600,26501
7193,uivraeus,1,0.00377,25425,95.93978,26501
7194,uklg,1,0.00377,25426,95.94355,26501
7195,ulrichb,1,0.00377,25427,95.94732,26501
7196,ulrichwinter,1,0.00377,25428,95.95110,26501
7197,UltimateJava,1,0.00377,25429,95.95487,26501
7198,UltraViolentLight,1,0.00377,25430,95.95864,26501
7199,umgbhalla,1,0.00377,25431,95.96242,26501
7200,umuteyilmaz,1,0.00377,25432,95.96619,26501
7201,undefinedhashtag,1,0.00377,25433,95.96996,26501
7202,unfeeling91,1,0.00377,25434,95.97374,26501
7203,unidevel,1,0.00377,25435,95.97751,26501
7204,unlaudable,1,0.00377,25436,95.98128,26501
7205,unlightable,1,0.00377,25437,95.98506,26501
7206,unrealhoang,1,0.00377,25438,95.98883,26501
7207,unwork-ag,1,0.00377,25439,95.99260,26501
7208,upcJack,1,0.00377,25440,95.99638,26501
7209,uroshercog,1,0.00377,25441,96.00015,26501
7210,ushiii111798,1,0.00377,25442,96.00392,26501
7211,UtR491,1,0.00377,25443,96.00770,26501
7212,uttkumert,1,0.00377,25444,96.01147,26501
7213,uya116,1,0.00377,25445,96.01524,26501
7214,VaclavK,1,0.00377,25446,96.01902,26501
7215,vadherajuFis,1,0.00377,25447,96.02279,26501
7216,vadimkhm,1,0.00377,25448,96.02657,26501
7217,vadimzhukck,1,0.00377,25449,96.03034,26501
7218,vahidkhosh,1,0.00377,25450,96.03411,26501
7219,Vaibhav1919,1,0.00377,25451,96.03789,26501
7220,VainoTonis,1,0.00377,25452,96.04166,26501
7221,vaish1707,1,0.00377,25453,96.04543,26501
7222,vaishnavan26,1,0.00377,25454,96.04921,26501
7223,vaishnavi216,1,0.00377,25455,96.05298,26501
7224,valdidar,1,0.00377,25456,96.05675,26501
7225,valeriodelsarto,1,0.00377,25457,96.06053,26501
7226,ValetteValette,1,0.00377,25458,96.06430,26501
7227,valkyr13,1,0.00377,25459,96.06807,26501
7228,varadkarpe,1,0.00377,25460,96.07185,26501
7229,VariabileAleatoria,1,0.00377,25461,96.07562,26501
7230,Varunaditya,1,0.00377,25462,96.07939,26501
7231,VarunTyagi86,1,0.00377,25463,96.08317,26501
7232,vasanianil,1,0.00377,25464,96.08694,26501
7233,vasilev-alex,1,0.00377,25465,96.09071,26501
7234,vasudev-bongale,1,0.00377,25466,96.09449,26501
7235,vbshnsk,1,0.00377,25467,96.09826,26501
7236,veerakadi,1,0.00377,25468,96.10203,26501
7237,VeithBuergerhoff,1,0.00377,25469,96.10581,26501
7238,velenux,1,0.00377,25470,96.10958,26501
7239,veloting,1,0.00377,25471,96.11335,26501
7240,venkataramaredy,1,0.00377,25472,96.11713,26501
7241,VenkatesanSathish,1,0.00377,25473,96.12090,26501
7242,verovec,1,0.00377,25474,96.12467,26501
7243,vguar,1,0.00377,25475,96.12845,26501
7244,Vibano007,1,0.00377,25476,96.13222,26501
7245,vic-cekvenich,1,0.00377,25477,96.13599,26501
7246,victor-khazanov,1,0.00377,25478,96.13977,26501
7247,victorlapshev,1,0.00377,25479,96.14354,26501
7248,videap,1,0.00377,25480,96.14732,26501
7249,vifeng,1,0.00377,25481,96.15109,26501
7250,vijayibm,1,0.00377,25482,96.15486,26501
7251,vijaykumar219,1,0.00377,25483,96.15864,26501
7252,viktormarinho,1,0.00377,25484,96.16241,26501
7253,ViktorSchlaffer,1,0.00377,25485,96.16618,26501
7254,vinaydhegde,1,0.00377,25486,96.16996,26501
7255,vinaygoel586,1,0.00377,25487,96.17373,26501
7256,vinay-ksingh,1,0.00377,25488,96.17750,26501
7257,vincent-chan-hk,1,0.00377,25489,96.18128,26501
7258,VincentDu2021,1,0.00377,25490,96.18505,26501
7259,vineetguptadev,1,0.00377,25491,96.18882,26501
7260,vinerich,1,0.00377,25492,96.19260,26501
7261,vinodhrajasekharan,1,0.00377,25493,96.19637,26501
7262,virtualpeter,1,0.00377,25494,96.20014,26501
7263,vishal549,1,0.00377,25495,96.20392,26501
7264,VishalCR7,1,0.00377,25496,96.20769,26501
7265,vishalsignity,1,0.00377,25497,96.21146,26501
7266,VishnuAnand,1,0.00377,25498,96.21524,26501
7267,vishwajitdandage-psl,1,0.00377,25499,96.21901,26501
7268,VishwasSomasekhariah,1,0.00377,25500,96.22278,26501
7269,ViswaJag,1,0.00377,25501,96.22656,26501
7270,Vitron1778,1,0.00377,25502,96.23033,26501
7271,vivek-ac,1,0.00377,25503,96.23410,26501
7272,vividfish,1,0.00377,25504,96.23788,26501
7273,vix633,1,0.00377,25505,96.24165,26501
7274,vjcracker,1,0.00377,25506,96.24542,26501
7275,vkannemacher,1,0.00377,25507,96.24920,26501
7276,vladi-kulkov,1,0.00377,25508,96.25297,26501
7277,vladyslav-burylov,1,0.00377,25509,96.25675,26501
7278,vmarusic,1,0.00377,25510,96.26052,26501
7279,voidtek,1,0.00377,25511,96.26429,26501
7280,VolodymyrFesenko,1,0.00377,25512,96.26807,26501
7281,vooidzero,1,0.00377,25513,96.27184,26501
7282,VorapratR,1,0.00377,25514,96.27561,26501
7283,votdev,1,0.00377,25515,96.27939,26501
7284,vpekarek,1,0.00377,25516,96.28316,26501
7285,vsabavat,1,0.00377,25517,96.28693,26501
7286,vsfomin,1,0.00377,25518,96.29071,26501
7287,vstoppe,1,0.00377,25519,96.29448,26501
7288,vvarga007,1,0.00377,25520,96.29825,26501
7289,vykut,1,0.00377,25521,96.30203,26501
7290,vyredo,1,0.00377,25522,96.30580,26501
7291,W07FP4X,1,0.00377,25523,96.30957,26501
7292,waaghals,1,0.00377,25524,96.31335,26501
7293,waalkman,1,0.00377,25525,96.31712,26501
7294,Wackerle,1,0.00377,25526,96.32089,26501
7295,Wagnard,1,0.00377,25527,96.32467,26501
7296,wahaj4311,1,0.00377,25528,96.32844,26501
7297,wajeshubham,1,0.00377,25529,96.33221,26501
7298,walsw,1,0.00377,25530,96.33599,26501
7299,walthowd,1,0.00377,25531,96.33976,26501
7300,WangFengyi0228,1,0.00377,25532,96.34353,26501
7301,wangjian-pg,1,0.00377,25533,96.34731,26501
7302,WangYichen2000,1,0.00377,25534,96.35108,26501
7303,warstrolo,1,0.00377,25535,96.35485,26501
7304,waskow-consensys,1,0.00377,25536,96.35863,26501
7305,waterdrinker,1,0.00377,25537,96.36240,26501
7306,way-zer,1,0.00377,25538,96.36617,26501
7307,wbenmurimi,1,0.00377,25539,96.36995,26501
7308,wcarmon,1,0.00377,25540,96.37372,26501
7309,wduncanfraser,1,0.00377,25541,96.37750,26501
7310,WebscienceXYZ,1,0.00377,25542,96.38127,26501
7311,weidox,1,0.00377,25543,96.38504,26501
7312,weiqiangxu,1,0.00377,25544,96.38882,26501
7313,Welkin-Y,1,0.00377,25545,96.39259,26501
7314,welsper-yang,1,0.00377,25546,96.39636,26501
7315,wemod123,1,0.00377,25547,96.40014,26501
7316,wenhuizhang,1,0.00377,25548,96.40391,26501
7317,wenijinew,1,0.00377,25549,96.40768,26501
7318,Wennn,1,0.00377,25550,96.41146,26501
7319,wfly1998,1,0.00377,25551,96.41523,26501
7320,Wheedman,1,0.00377,25552,96.41900,26501
7321,will-codes-things,1,0.00377,25553,96.42278,26501
7322,WillemMe,1,0.00377,25554,96.42655,26501
7323,WillemNoort,1,0.00377,25555,96.43032,26501
7324,WilliamGFish,1,0.00377,25556,96.43410,26501
7325,willkara,1,0.00377,25557,96.43787,26501
7326,wilywork,1,0.00377,25558,96.44164,26501
7327,wintle777,1,0.00377,25559,96.44542,26501
7328,wirekang,1,0.00377,25560,96.44919,26501
7329,wmendes-ionos,1,0.00377,25561,96.45296,26501
7330,wmessiassilva,1,0.00377,25562,96.45674,26501
7331,wmunyan,1,0.00377,25563,96.46051,26501
7332,wojciehm,1,0.00377,25564,96.46428,26501
7333,wojiaohanliyang,1,0.00377,25565,96.46806,26501
7334,wojtekbacza-coco,1,0.00377,25566,96.47183,26501
7335,Wolffy101,1,0.00377,25567,96.47560,26501
7336,WolfGanGeRTech,1,0.00377,25568,96.47938,26501
7337,wombat9000,1,0.00377,25569,96.48315,26501
7338,wonderzerg,1,0.00377,25570,96.48693,26501
7339,Woodrow1026,1,0.00377,25571,96.49070,26501
7340,woot3d,1,0.00377,25572,96.49447,26501
7341,wouter-toppy,1,0.00377,25573,96.49825,26501
7342,wqshr12345,1,0.00377,25574,96.50202,26501
7343,WqyJh,1,0.00377,25575,96.50579,26501
7344,wrkntwrkn,1,0.00377,25576,96.50957,26501
7345,wscourge,1,0.00377,25577,96.51334,26501
7346,wshallum,1,0.00377,25578,96.51711,26501
7347,wsoesanto,1,0.00377,25579,96.52089,26501
7348,wssrronak,1,0.00377,25580,96.52466,26501
7349,wudong5,1,0.00377,25581,96.52843,26501
7350,wufei523,1,0.00377,25582,96.53221,26501
7351,wujunfu,1,0.00377,25583,96.53598,26501
7352,wukunliu,1,0.00377,25584,96.53975,26501
7353,wureka,1,0.00377,25585,96.54353,26501
7354,wuxin001,1,0.00377,25586,96.54730,26501
7355,wwolfe-mend,1,0.00377,25587,96.55107,26501
7356,wwwted,1,0.00377,25588,96.55485,26501
7357,Wyifei,1,0.00377,25589,96.55862,26501
7358,W-YJ,1,0.00377,25590,96.56239,26501
7359,wynxel,1,0.00377,25591,96.56617,26501
7360,wytrych,1,0.00377,25592,96.56994,26501
7361,wzhdev,1,0.00377,25593,96.57371,26501
7362,xckai,1,0.00377,25594,96.57749,26501
7363,xepozz,1,0.00377,25595,96.58126,26501
7364,xfl03,1,0.00377,25596,96.58503,26501
7365,xhu-cloudera,1,0.00377,25597,96.58881,26501
7366,xiangyeping,1,0.00377,25598,96.59258,26501
7367,xiaodong-acc,1,0.00377,25599,96.59635,26501
7368,xiaojifan,1,0.00377,25600,96.60013,26501
7369,xiaonanshen-ponyai,1,0.00377,25601,96.60390,26501
7370,xiaozhijina,1,0.00377,25602,96.60768,26501
7371,xierunzi,1,0.00377,25603,96.61145,26501
7372,xin-tsla,1,0.00377,25604,96.61522,26501
7373,xiongyu0523,1,0.00377,25605,96.61900,26501
7374,xixiangzouyibian,1,0.00377,25606,96.62277,26501
7375,xjl123456,1,0.00377,25607,96.62654,26501
7376,xjxu-09,1,0.00377,25608,96.63032,26501
7377,Xosmond,1,0.00377,25609,96.63409,26501
7378,xqk,1,0.00377,25610,96.63786,26501
7379,XuanMichael,1,0.00377,25611,96.64164,26501
7380,xubo3006,1,0.00377,25612,96.64541,26501
7381,xueh007,1,0.00377,25613,96.64918,26501
7382,xueyin220807,1,0.00377,25614,96.65296,26501
7383,XuhuiSun95,1,0.00377,25615,96.65673,26501
7384,xuthus5,1,0.00377,25616,96.66050,26501
7385,xuyanzhuo,1,0.00377,25617,96.66428,26501
7386,xval2307,1,0.00377,25618,96.66805,26501
7387,xw41,1,0.00377,25619,96.67182,26501
7388,Xxf9126,1,0.00377,25620,96.67560,26501
7389,XXXLutz,1,0.00377,25621,96.67937,26501
7390,xycloops123,1,0.00377,25622,96.68314,26501
7391,XyHalcyon,1,0.00377,25623,96.68692,26501
7392,yaaraze,1,0.00377,25624,96.69069,26501
7393,yangguang111aaa,1,0.00377,25625,96.69446,26501
7394,yangjiwei-source,1,0.00377,25626,96.69824,26501
7395,YangLoveYing,1,0.00377,25627,96.70201,26501
7396,yangwenyi1995,1,0.00377,25628,96.70578,26501
7397,yangxiaojuan-loongson,1,0.00377,25629,96.70956,26501
7398,yangzhiwei256,1,0.00377,25630,96.71333,26501
7399,Yann-J,1,0.00377,25631,96.71711,26501
7400,yaoxinwang-git,1,0.00377,25632,96.72088,26501
7401,YaserAmini88,1,0.00377,25633,96.72465,26501
7402,yash2189,1,0.00377,25634,96.72843,26501
7403,Yash-Raj-srivastav,1,0.00377,25635,96.73220,26501
7404,yash-sarda,1,0.00377,25636,96.73597,26501
7405,yasinzaehringer-paradime,1,0.00377,25637,96.73975,26501
7406,yassineaouadi,1,0.00377,25638,96.74352,26501
7407,yazanmonshed,1,0.00377,25639,96.74729,26501
7408,ybasket,1,0.00377,25640,96.75107,26501
7409,ybleeho,1,0.00377,25641,96.75484,26501
7410,yc185050,1,0.00377,25642,96.75861,26501
7411,Ycallaer,1,0.00377,25643,96.76239,26501
7412,ydeng-splunk,1,0.00377,25644,96.76616,26501
7413,yellenseram,1,0.00377,25645,96.76993,26501
7414,yellowstar1014,1,0.00377,25646,96.77371,26501
7415,yelvert,1,0.00377,25647,96.77748,26501
7416,Yerolkar123,1,0.00377,25648,96.78125,26501
7417,YeYoot,1,0.00377,25649,96.78503,26501
7418,yifeiwublazer,1,0.00377,25650,96.78880,26501
7419,yigitpolat,1,0.00377,25651,96.79257,26501
7420,Yilialinn,1,0.00377,25652,96.79635,26501
7421,yilmazyildirim,1,0.00377,25653,96.80012,26501
7422,ying62506799,1,0.00377,25654,96.80389,26501
7423,yinshurman,1,0.00377,25655,96.80767,26501
7424,yiqin,1,0.00377,25656,96.81144,26501
7425,yiranyao,1,0.00377,25657,96.81521,26501
7426,yitistica,1,0.00377,25658,96.81899,26501
7427,yjianzhu,1,0.00377,25659,96.82276,26501
7428,yk,1,0.00377,25660,96.82653,26501
7429,ykk0612,1,0.00377,25661,96.83031,26501
7430,ylifigma,1,0.00377,25662,96.83408,26501
7431,ymadhumohanreddi,1,0.00377,25663,96.83786,26501
7432,yngfoxx,1,0.00377,25664,96.84163,26501
7433,yoelpg,1,0.00377,25665,96.84540,26501
7434,yogingang,1,0.00377,25666,96.84918,26501
7435,YohanSciubukgian,1,0.00377,25667,96.85295,26501
7436,YokkiShi,1,0.00377,25668,96.85672,26501
7437,yomi40,1,0.00377,25669,96.86050,26501
7438,yongfook,1,0.00377,25670,96.86427,26501
7439,YOU54F,1,0.00377,25671,96.86804,26501
7440,youkpan,1,0.00377,25672,96.87182,26501
7441,Youtage,1,0.00377,25673,96.87559,26501
7442,yudiz-amanm,1,0.00377,25674,96.87936,26501
7443,yuedongze,1,0.00377,25675,96.88314,26501
7444,yuichi-nakamura,1,0.00377,25676,96.88691,26501
7445,YukiDayDreamer,1,0.00377,25677,96.89068,26501
7446,yumingqiao,1,0.00377,25678,96.89446,26501
7447,yunim2022,1,0.00377,25679,96.89823,26501
7448,Yun-Kim,1,0.00377,25680,96.90200,26501
7449,yunussandikci,1,0.00377,25681,96.90578,26501
7450,yurikrupnik,1,0.00377,25682,96.90955,26501
7451,YuriMcQueen,1,0.00377,25683,96.91332,26501
7452,yuval0499,1,0.00377,25684,96.91710,26501
7453,yvdewall,1,0.00377,25685,96.92087,26501
7454,yzhan289,1,0.00377,25686,96.92464,26501
7455,z15alall,1,0.00377,25687,96.92842,26501
7456,zachwalton,1,0.00377,25688,96.93219,26501
7457,zainabmirkar,1,0.00377,25689,96.93596,26501
7458,zaki-salaheddine,1,0.00377,25690,96.93974,26501
7459,zaksnet,1,0.00377,25691,96.94351,26501
7460,zalejus,1,0.00377,25692,96.94729,26501
7461,zaljic,1,0.00377,25693,96.95106,26501
7462,zaninime,1,0.00377,25694,96.95483,26501
7463,zaphinath,1,0.00377,25695,96.95861,26501
7464,zarinfam,1,0.00377,25696,96.96238,26501
7465,ZatoIchi,1,0.00377,25697,96.96615,26501
7466,zatu22,1,0.00377,25698,96.96993,26501
7467,zaycker,1,0.00377,25699,96.97370,26501
7468,zbdba,1,0.00377,25700,96.97747,26501
7469,z-bool,1,0.00377,25701,96.98125,26501
7470,zby-hub,1,0.00377,25702,96.98502,26501
7471,zcharym,1,0.00377,25703,96.98879,26501
7472,zdrapela,1,0.00377,25704,96.99257,26501
7473,zedge-it,1,0.00377,25705,96.99634,26501
7474,zemul,1,0.00377,25706,97.00011,26501
7475,zenzedoon,1,0.00377,25707,97.00389,26501
7476,ZeroExistence,1,0.00377,25708,97.00766,26501
7477,zerohours,1,0.00377,25709,97.01143,26501
7478,zetinja,1,0.00377,25710,97.01521,26501
7479,zetti12345,1,0.00377,25711,97.01898,26501
7480,zgyyun,1,0.00377,25712,97.02275,26501
7481,ZhangChaoming,1,0.00377,25713,97.02653,26501
7482,zhangchi2217,1,0.00377,25714,97.03030,26501
7483,zhaomingcheng01,1,0.00377,25715,97.03407,26501
7484,zhaorizhao,1,0.00377,25716,97.03785,26501
7485,zhaot0018,1,0.00377,25717,97.04162,26501
7486,zhenglinhui,1,0.00377,25718,97.04539,26501
7487,zhenguozhang,1,0.00377,25719,97.04917,26501
7488,zhews,1,0.00377,25720,97.05294,26501
7489,zhiyi57,1,0.00377,25721,97.05671,26501
7490,ZholobovSS,1,0.00377,25722,97.06049,26501
7491,zhoujiazhao,1,0.00377,25723,97.06426,26501
7492,zhuanvgui,1,0.00377,25724,97.06804,26501
7493,zhubao315,1,0.00377,25725,97.07181,26501
7494,zhuqi-lucas,1,0.00377,25726,97.07558,26501
7495,zhuyuanmao,1,0.00377,25727,97.07936,26501
7496,ziadmoubayed,1,0.00377,25728,97.08313,26501
7497,Zia-Eurus,1,0.00377,25729,97.08690,26501
7498,ziminyuri,1,0.00377,25730,97.09068,26501
7499,ziomill,1,0.00377,25731,97.09445,26501
7500,zisisli,1,0.00377,25732,97.09822,26501
7501,zjlooojoe,1,0.00377,25733,97.10200,26501
7502,zjp99,1,0.00377,25734,97.10577,26501
7503,ZJUGuoShuai,1,0.00377,25735,97.10954,26501
7504,zlcolin,1,0.00377,25736,97.11332,26501
7505,zll600,1,0.00377,25737,97.11709,26501
7506,zmaktouf,1,0.00377,25738,97.12086,26501
7507,z-mani,1,0.00377,25739,97.12464,26501
7508,zmccoy,1,0.00377,25740,97.12841,26501
7509,zmdstr,1,0.00377,25741,97.13218,26501
7510,zmf0507,1,0.00377,25742,97.13596,26501
7511,zmrubin,1,0.00377,25743,97.13973,26501
7512,zmwaris1,1,0.00377,25744,97.14350,26501
7513,ZoltanPD,1,0.00377,25745,97.14728,26501
7514,Zonalds,1,0.00377,25746,97.15105,26501
7515,zone31,1,0.00377,25747,97.15482,26501
7516,ZongHR,1,0.00377,25748,97.15860,26501
7517,ZonzeeLi,1,0.00377,25749,97.16237,26501
7518,zooneon,1,0.00377,25750,97.16614,26501
7519,zOr924,1,0.00377,25751,97.16992,26501
7520,Zorkbomb,1,0.00377,25752,97.17369,26501
7521,Zorvalt,1,0.00377,25753,97.17747,26501
7522,ZRainc,1,0.00377,25754,97.18124,26501
7523,zzj0402,1,0.00377,25755,97.18501,26501
7524,zzyyzte,1,0.00377,25756,97.18879,26501
